StockCode,Recency,Frequency,Monetary,R,F,M,RFM_Score,LoyalCustomer,Predicted_LoyalCustomer
10002,235,71,759.89,4,3,3,10,1,1
10080,18,22,119.08999999999999,3,2,1,6,0,0
10120,5,29,40.53,3,2,1,6,0,0
10123C,253,3,3.25,4,1,1,6,0,0
10124A,33,5,6.72,4,1,1,6,0,0
10124G,33,4,7.14,4,1,1,6,0,0
10125,1,91,994.84,1,3,3,7,0,0
10133,94,197,1548.42,4,4,3,11,1,1
10135,2,176,2208.64,2,4,3,9,1,1
11001,3,118,2626.49,2,3,4,9,1,1
15030,4,12,41.47,3,1,1,5,0,0
15034,2,142,948.3100000000001,2,3,3,8,0,0
15036,1,522,19075.52,1,4,4,9,1,1
15039,1,148,2001.59,1,3,3,7,0,0
15044A,4,103,1459.67,3,3,3,9,1,1
15044B,72,61,949.7800000000001,4,2,3,9,1,1
15044C,3,90,1033.99,2,3,3,8,0,0
15044D,4,86,1828.21,3,3,3,9,1,1
15056BL,1,326,16481.34,1,4,4,9,1,1
15056N,1,463,22513.940000000002,1,4,4,9,1,1
15056P,1,148,4425.02,1,3,4,8,0,0
15056bl,1,62,1086.88,1,2,3,6,0,0
15056n,9,84,1585.2800000000002,3,3,3,9,1,1
15056p,5,26,412.48,3,2,2,7,0,0
15058A,17,93,1705.84,3,3,3,9,1,1
15058B,22,99,1922.62,3,3,3,9,1,1
15058C,1,72,1429.82,1,3,3,7,0,0
15060B,21,132,1811.3,3,3,3,9,1,1
15060b,19,3,24.869999999999997,3,1,1,5,0,0
16008,1,70,360.71,1,3,2,6,0,0
16010,256,3,3.5999999999999996,4,1,1,6,0,0
16011,3,46,372.33,2,2,2,6,0,0
16012,4,35,261.24,3,2,2,7,0,0
16014,1,54,4335.76,1,2,4,7,0,0
16015,22,24,289.98,3,2,2,7,0,0
16016,1,65,1053.45,1,2,3,6,0,0
16020C,157,17,69.89999999999999,4,2,1,7,0,0
16033,295,4,100.79999999999998,4,1,1,6,0,0
16043,183,2,11.759999999999998,4,1,1,6,0,0
16045,5,68,380.0,3,3,2,8,0,0
16046,12,14,57.8,3,1,1,5,0,0
16048,2,67,205.42,2,3,2,7,0,0
16049,199,5,82.08,4,1,1,6,0,0
16052,183,13,115.3,4,1,1,6,0,0
16054,5,34,153.48000000000002,3,2,2,7,0,0
16151A,199,3,61.25,4,1,1,6,0,0
16156L,8,18,199.5,3,2,2,7,0,0
16156S,2,167,2331.0,2,3,4,9,1,1
16161G,16,22,70.0,3,2,1,6,0,0
16161M,372,1,10.5,4,1,1,6,0,0
16161P,3,249,3001.42,2,4,4,10,1,1
16161U,7,135,1698.0,3,3,3,9,1,1
16162L,88,8,13.0,4,1,1,6,0,0
16162M,12,8,11.76,3,1,1,5,0,0
16168M,1,41,173.12,1,2,2,5,0,0
16169E,1,151,1944.96,1,3,3,7,0,0
16169K,72,8,84.0,4,1,1,6,0,0
16169M,8,25,277.2,3,2,2,7,0,0
16169N,369,1,10.5,4,1,1,6,0,0
16169P,356,2,21.0,4,1,1,6,0,0
16202A,236,2,3.5,4,1,1,6,0,0
16202B,234,2,14.5,4,1,1,6,0,0
16202E,236,4,13.05,4,1,1,6,0,0
16206B,318,2,8.75,4,1,1,6,0,0
16207A,33,34,163.1,4,2,2,8,0,0
16207B,102,18,76.14,4,2,1,7,0,0
16216,3,45,234.0,2,2,2,6,0,0
16218,1,64,283.31,1,2,2,5,0,0
16219,1,101,410.59999999999997,1,3,2,6,0,0
16225,1,102,691.85,1,3,2,6,0,0
16235,1,169,703.17,1,4,3,8,0,0
16236,2,136,320.09,2,3,2,7,0,0
16237,1,291,1061.16,1,4,3,8,0,0
16238,2,134,322.09,2,3,2,7,0,0
16244B,212,2,7.85,4,1,1,6,0,0
16248B,40,7,16.25,4,1,1,6,0,0
16254,9,17,42.58,3,2,1,6,0,0
16258A,2,60,179.39,2,2,2,6,0,0
16259,27,32,335.2,3,2,2,7,0,0
17001,284,1,20.88,4,1,1,6,0,0
17003,1,242,6209.19,1,4,4,9,1,1
17007B,184,2,50.400000000000006,4,1,1,6,0,0
17011F,205,7,66.36000000000001,4,1,1,6,0,0
17012A,7,65,375.93,3,2,2,7,0,0
17012B,9,85,595.85,3,3,2,8,0,0
17012C,2,85,484.34999999999997,2,3,2,7,0,0
17012D,1,97,550.64,1,3,2,6,0,0
17012E,359,10,74.64,4,1,1,6,0,0
17012F,1,94,530.6,1,3,2,6,0,0
17013D,186,13,267.82,4,1,2,7,0,0
17014A,165,8,71.19,4,1,1,6,0,0
17021,4,47,643.14,3,2,2,7,0,0
17028J,312,1,2.52,4,1,1,6,0,0
17038,1,34,158.06,1,2,2,5,0,0
17084A,87,7,42.0,4,1,1,6,0,0
17084J,87,8,47.25,4,1,1,6,0,0
17084N,1,101,313.31,1,3,2,6,0,0
17084P,1,39,104.44,1,2,1,4,0,0
17084R,5,27,760.3199999999999,3,2,3,8,0,0
17090A,16,10,107.44999999999999,3,1,1,5,0,0
17090D,152,12,36.25,4,1,1,6,0,0
17091A,206,25,99.29,4,2,1,7,0,0
17091J,1,95,920.67,1,3,3,7,0,0
17096,143,24,455.9800000000001,4,2,2,8,0,0
17107D,4,46,436.04999999999995,3,2,2,7,0,0
17109D,233,5,32.349999999999994,4,1,1,6,0,0
17129F,4,58,555.53,3,2,2,7,0,0
17136A,36,17,33.75,4,2,1,7,0,0
17164B,317,9,12.18,4,1,1,6,0,0
17165D,331,7,28.35,4,1,1,6,0,0
17174,15,3,3.7800000000000002,3,1,1,5,0,0
17191A,6,2,15.0,3,1,1,5,0,0
18007,142,30,395.61,4,2,2,8,0,0
18094C,63,42,283.93,4,2,2,8,0,0
18097A,170,4,12.75,4,1,1,6,0,0
18097C,1,71,2173.01,1,3,3,7,0,0
18098C,123,49,658.75,4,2,2,8,0,0
18098c,353,12,263.12,4,1,2,7,0,0
20615,1,95,466.99,1,3,2,6,0,0
20616,1,71,243.53,1,3,2,6,0,0
20617,1,43,194.94,1,2,2,5,0,0
20618,3,76,286.39,2,3,2,7,0,0
20619,4,99,439.65,3,3,2,8,0,0
20622,4,51,305.8,3,2,2,7,0,0
20652,1,78,350.61,1,3,2,6,0,0
20653,4,33,95.17999999999999,3,2,1,6,0,0
20654,1,49,193.59,1,2,2,5,0,0
20655,5,99,292.29,3,3,2,8,0,0
20657,29,33,105.91,3,2,1,6,0,0
20658,74,106,668.36,4,3,2,9,1,1
20659,1,62,248.09,1,2,2,5,0,0
20661,8,33,141.15,3,2,2,7,0,0
20662,46,20,90.42,4,2,1,7,0,0
20663,53,20,66.26,4,2,1,7,0,0
20664,102,18,81.66,4,2,1,7,0,0
20665,1,156,1546.2700000000002,1,3,3,7,0,0
20666,142,17,41.53,4,2,1,7,0,0
20667,102,16,49.69,4,1,1,6,0,0
20668,1,215,1512.92,1,4,3,8,0,0
20669,1,96,447.34,1,3,2,6,0,0
20670,24,11,44.04,3,1,1,5,0,0
20671,365,2,12.5,4,1,1,6,0,0
20674,1,206,2039.98,1,4,3,8,0,0
20675,1,324,3999.37,1,4,4,9,1,1
20676,1,451,6468.56,1,4,4,9,1,1
20677,1,334,4756.09,1,4,4,9,1,1
20678,77,1,6.6,4,1,1,6,0,0
20679,1,329,10074.970000000001,1,4,4,9,1,1
20681,249,48,513.46,4,2,2,8,0,0
20682,2,243,4255.83,2,4,4,10,1,1
20684,141,35,273.81,4,2,2,8,0,0
20685,1,703,28543.76,1,4,4,9,1,1
20686,1,77,932.42,1,3,3,7,0,0
20694,17,16,187.54,3,1,2,6,0,0
20695,22,4,21.25,3,1,1,5,0,0
20696,28,30,230.81,3,2,2,7,0,0
20697,17,11,53.55,3,1,1,5,0,0
20698,17,8,43.349999999999994,3,1,1,5,0,0
20699,4,41,266.03,3,2,2,7,0,0
20700,72,54,345.17,4,2,2,8,0,0
20701,162,18,100.97,4,2,1,7,0,0
20702,44,42,577.79,4,2,2,8,0,0
20703,190,4,34.0,4,1,1,6,0,0
20704,1,45,725.5,1,2,3,6,0,0
20705,4,29,430.8,3,2,2,7,0,0
20707,4,150,469.64,3,3,2,8,0,0
20711,8,529,11054.93,3,4,4,11,1,1
20712,1,872,22518.88,1,4,4,9,1,1
20713,1,663,23462.39,1,4,4,9,1,1
20716,164,73,469.63,4,3,2,9,1,1
20717,1,414,3591.98,1,4,4,9,1,1
20718,1,580,6656.03,1,4,4,9,1,1
20719,1,841,16847.15,1,4,4,9,1,1
20723,1,734,12615.11,1,4,4,9,1,1
20724,1,1048,21947.1,1,4,4,9,1,1
20725,1,1608,36896.71,1,4,4,9,1,1
20726,1,1036,18458.28,1,4,4,9,1,1
20727,1,1295,22623.41,1,4,4,9,1,1
20728,1,1173,22078.13,1,4,4,9,1,1
20731,172,16,109.96,4,1,1,6,0,0
20733,1,206,1174.06,1,4,3,8,0,0
20734,248,26,271.21999999999997,4,2,2,8,0,0
20735,3,112,625.8,2,3,2,7,0,0
20748,11,34,751.17,3,2,3,8,0,0
20749,1,389,12677.769999999999,1,4,4,9,1,1
20750,1,389,12690.63,1,4,4,9,1,1
20751,6,199,2110.82,3,4,3,10,1,1
20752,12,150,939.35,3,3,3,9,1,1
20754,19,305,3093.06,3,4,4,11,1,1
20755,3,62,272.02,2,2,2,6,0,0
20756,17,22,53.55,3,2,1,6,0,0
20757,13,33,144.29,3,2,2,7,0,0
20758,2,42,137.7,2,2,2,6,0,0
20759,2,20,54.4,2,2,1,5,0,0
20760,15,21,58.65,3,2,1,6,0,0
20761,3,63,517.22,2,2,2,6,0,0
20762,3,56,420.08,2,2,2,6,0,0
20763,4,27,205.04,3,2,2,7,0,0
20764,2,76,610.8100000000001,2,3,2,7,0,0
20765,4,59,423.55,3,2,2,7,0,0
20766,5,57,501.07,3,2,2,7,0,0
20767,3,79,663.7099999999999,2,3,2,7,0,0
20768,3,55,441.12,2,2,2,6,0,0
20769,3,34,217.55999999999997,2,2,2,6,0,0
20770,13,72,449.8,3,3,2,8,0,0
20771,3,40,269.68,2,2,2,6,0,0
20772,1,66,623.74,1,3,2,6,0,0
20773,88,23,92.39999999999999,4,2,1,7,0,0
20774,66,44,141.23999999999998,4,2,2,8,0,0
20775,4,63,235.18999999999997,3,2,2,7,0,0
20777,1,80,282.48999999999995,1,3,2,6,0,0
20778,227,8,24.75,4,1,1,6,0,0
20780,1,28,318.19,1,2,2,5,0,0
20781,2,26,227.14000000000001,2,2,2,6,0,0
20782,1,27,373.57,1,2,2,5,0,0
20785,248,5,523.3000000000001,4,1,2,7,0,0
20793,93,5,87.75,4,1,1,6,0,0
20794,3,29,305.74,2,2,2,6,0,0
20795,4,13,125.65,3,1,1,5,0,0
20796,30,9,103.93999999999998,3,1,1,5,0,0
20798,318,6,82.2,4,1,1,6,0,0
20801,198,83,1181.8,4,3,3,10,1,1
20802,4,65,1004.54,3,2,3,8,0,0
20803,222,42,507.28,4,2,2,8,0,0
20816,225,2,15.6,4,1,1,6,0,0
20818,219,5,42.7,4,1,1,6,0,0
20819,10,27,244.72,3,2,2,7,0,0
20820,283,2,24.75,4,1,1,6,0,0
20821,16,8,143.55,3,1,2,6,0,0
20823,183,8,132.72,4,1,2,7,0,0
20826,206,8,128.4,4,1,1,6,0,0
20827,233,2,34.32,4,1,1,6,0,0
20828,2,241,3079.88,2,4,4,10,1,1
20829,1,200,2930.31,1,4,4,9,1,1
20830,68,38,411.93,4,2,2,8,0,0
20831,1,39,466.53000000000003,1,2,2,5,0,0
20832,1,83,582.88,1,3,2,6,0,0
20835,29,8,65.8,3,1,1,5,0,0
20836,16,18,151.05999999999997,3,2,2,7,0,0
20837,20,15,142.47,3,1,2,6,0,0
20838,4,58,471.65,3,2,2,7,0,0
20839,1,105,840.4399999999999,1,3,3,7,0,0
20840,1,75,642.52,1,3,2,6,0,0
20845,115,11,120.64999999999999,4,1,1,6,0,0
20846,3,88,958.57,2,3,3,8,0,0
20847,15,18,217.57999999999998,3,2,2,7,0,0
20848,33,8,61.95,4,1,1,6,0,0
20851,226,7,53.550000000000004,4,1,1,6,0,0
20854,293,42,409.41999999999996,4,2,2,8,0,0
20856,122,62,373.78999999999996,4,2,2,8,0,0
20857,295,9,77.55,4,1,1,6,0,0
20860,361,1,2.1,4,1,1,6,0,0
20861,365,2,4.2,4,1,1,6,0,0
20866,1,91,838.15,1,3,3,7,0,0
20867,4,62,393.46999999999997,3,2,2,7,0,0
20868,1,46,219.35000000000002,1,2,2,5,0,0
20869,1,29,86.76,1,2,1,4,0,0
20871,360,1,8.42,4,1,1,6,0,0
20878,369,7,31.25,4,1,1,6,0,0
20886,33,104,999.88,4,3,3,10,1,1
20892,353,3,89.22,4,1,1,6,0,0
20893,6,27,687.1700000000001,3,2,2,7,0,0
20894,9,15,108.71000000000001,3,1,1,5,0,0
20897,102,26,333.67,4,2,2,8,0,0
20898,47,14,123.43,4,1,1,6,0,0
20901,25,16,104.17999999999999,3,1,1,5,0,0
20902,121,56,686.86,4,2,2,8,0,0
20903,47,56,441.89,4,2,2,8,0,0
20906,250,2,8.850000000000001,4,1,1,6,0,0
20910,359,3,50.8,4,1,1,6,0,0
20914,1,914,18691.05,1,4,4,9,1,1
20931,1,71,1105.95,1,3,3,7,0,0
20932,1,37,658.2900000000001,1,2,2,5,0,0
20933,2,9,71.05,2,1,1,4,0,0
20934,35,36,499.76,4,2,2,8,0,0
20935,23,4,17.700000000000003,3,1,1,5,0,0
20936,1,35,322.61,1,2,2,5,0,0
20941,156,20,86.28,4,2,1,7,0,0
20954,357,2,16.94,4,1,1,6,0,0
20956,3,103,1155.27,2,3,3,8,0,0
20957,373,1,1.45,4,1,1,6,0,0
20960,278,10,72.49,4,1,1,6,0,0
20961,1,229,1811.68,1,4,3,8,0,0
20963,1,229,1913.67,1,4,3,8,0,0
20964,218,1,5.1,4,1,1,6,0,0
20966,108,97,1022.8,4,3,3,10,1,1
20967,44,83,1031.69,4,3,3,10,1,1
20969,1,307,8217.0,1,4,4,9,1,1
20970,1,264,4247.13,1,4,4,9,1,1
20971,1,526,16616.87,1,4,4,9,1,1
20972,1,618,9189.31,1,4,4,9,1,1
20973,1,357,3218.7200000000003,1,4,4,9,1,1
20974,1,358,4899.88,1,4,4,9,1,1
20975,1,366,4465.820000000001,1,4,4,9,1,1
20977,32,189,2424.89,4,4,4,12,1,1
20978,1,264,2420.05,1,4,4,9,1,1
20979,1,341,4929.9800000000005,1,4,4,9,1,1
20980,123,21,88.16,4,2,1,7,0,0
20981,1,253,1758.4199999999998,1,4,3,8,0,0
20982,1,259,1888.32,1,4,3,8,0,0
20983,1,271,2388.41,1,4,4,9,1,1
20984,54,171,1180.86,4,4,3,11,1,1
20985,1,134,1565.02,1,3,3,7,0,0
20986,1,113,833.49,1,3,3,7,0,0
20992,1,277,1965.81,1,4,3,8,0,0
20996,1,225,727.46,1,4,3,8,0,0
20997,2,34,257.61,2,2,2,6,0,0
20998,56,69,505.20000000000005,4,3,2,9,1,1
21000,1,52,365.09,1,2,2,5,0,0
21001,2,50,354.14,2,2,2,6,0,0
21002,48,66,428.66,4,3,2,9,1,1
21003,2,46,460.58,2,2,2,6,0,0
21009,357,1,1.25,4,1,1,6,0,0
21011,354,3,28.999999999999996,4,1,1,6,0,0
21012,1,200,2624.55,1,4,4,9,1,1
21014,16,119,598.8199999999999,3,3,2,8,0,0
21015,1,143,591.29,1,3,2,6,0,0
21018,357,6,22.06,4,1,1,6,0,0
21025,3,56,233.52,2,2,2,6,0,0
21026,1,68,319.5,1,3,2,6,0,0
21027,19,42,190.29,3,2,2,7,0,0
21028,1,58,239.24,1,2,2,5,0,0
21030,19,33,172.2,3,2,2,7,0,0
21031,24,19,65.49,3,2,1,6,0,0
21032,10,30,119.03,3,2,1,6,0,0
21033,92,301,4855.6,4,4,4,12,1,1
21034,1,874,1862.0,1,4,3,8,0,0
21035,1,396,9099.85,1,4,4,9,1,1
21038,219,24,92.65,4,2,1,7,0,0
21039,3,92,1384.29,2,3,3,8,0,0
21040,269,8,29.7,4,1,1,6,0,0
21041,16,258,3918.48,3,4,4,11,1,1
21042,2,136,2239.8700000000003,2,3,3,8,0,0
21043,185,90,1143.76,4,3,3,10,1,1
21051,2,51,377.2,2,2,2,6,0,0
21054,26,29,634.53,3,2,2,7,0,0
21055,1,106,1836.2399999999998,1,3,3,7,0,0
21056,2,74,1783.3,2,3,3,8,0,0
21058,2,123,978.41,2,3,3,8,0,0
21059,2,95,538.43,2,3,2,7,0,0
21060,4,71,359.28999999999996,3,3,2,8,0,0
21061,5,83,451.7,3,3,2,8,0,0
21062,7,74,458.22999999999996,3,3,2,8,0,0
21063,4,102,458.31,3,3,2,8,0,0
21064,1,101,1301.55,1,3,3,7,0,0
21065,1,90,1172.48,1,3,3,7,0,0
21066,9,55,709.72,3,2,3,8,0,0
21067,66,79,536.03,4,3,2,9,1,1
21068,1,201,1935.99,1,4,3,8,0,0
21069,114,87,2994.83,4,3,4,11,1,1
21070,1,107,1186.23,1,3,3,7,0,0
21071,39,178,1391.64,4,4,3,11,1,1
21078,57,313,2540.39,4,4,4,12,1,1
21080,1,988,11333.81,1,4,4,9,1,1
21082,164,25,143.44,4,2,2,8,0,0
21084,3,182,777.7,2,4,3,9,1,1
21086,3,428,4861.900000000001,2,4,4,10,1,1
21087,234,16,74.57000000000001,4,1,1,6,0,0
21088,1,104,430.56,1,3,2,6,0,0
21089,114,25,48.99,4,2,1,7,0,0
21090,3,220,1292.27,2,4,3,9,1,1
21094,2,527,6933.259999999999,2,4,4,10,1,1
21095,176,14,118.72999999999999,4,1,1,6,0,0
21096,2,105,581.09,2,3,2,7,0,0
21098,1,250,5135.67,1,4,4,9,1,1
21100,262,27,162.20999999999998,4,2,2,8,0,0
21106,7,53,702.51,3,2,3,8,0,0
21107,3,97,2501.56,2,3,4,9,1,1
21108,1,265,24660.7,1,4,4,9,1,1
21109,1,112,2765.15,1,3,4,8,0,0
21110,14,135,3835.95,3,3,4,10,1,1
21111,1,94,1652.27,1,3,3,7,0,0
21112,5,82,2885.13,3,3,4,10,1,1
21114,5,139,1821.83,3,3,3,9,1,1
21115,1,162,3174.84,1,3,4,8,0,0
21116,4,251,4051.79,3,4,4,11,1,1
21117,16,14,149.25,3,1,2,6,0,0
21120,365,1,16.98,4,1,1,6,0,0
21121,1,382,8153.85,1,4,4,9,1,1
21122,1,347,6557.29,1,4,4,9,1,1
21123,1,155,1413.34,1,3,3,7,0,0
21124,1,243,4929.3,1,4,4,9,1,1
21125,1,105,837.23,1,3,3,7,0,0
21126,1,126,750.2,1,3,3,7,0,0
21128,2,36,546.6,2,2,2,6,0,0
21129,11,28,433.42,3,2,2,7,0,0
21131,3,28,398.02,2,2,2,6,0,0
21132,1,22,217.35999999999999,1,2,2,5,0,0
21135,2,180,3336.41,2,4,4,10,1,1
21136,1,372,7845.53,1,4,4,9,1,1
21137,1,380,40707.3,1,4,4,9,1,1
21143,109,38,713.0799999999999,4,2,3,9,1,1
21144,339,3,21.36,4,1,1,6,0,0
21145,23,8,152.5,3,1,2,6,0,0
21147,4,76,415.77,3,3,2,8,0,0
21154,1,455,6548.76,1,4,4,9,1,1
21155,1,498,9812.0,1,4,4,9,1,1
21156,1,366,6169.099999999999,1,4,4,9,1,1
21157,45,34,227.6,4,2,2,8,0,0
21158,1,171,793.18,1,4,3,8,0,0
21159,1,124,602.18,1,3,2,6,0,0
21160,360,1,3.36,4,1,1,6,0,0
21161,185,43,231.36999999999998,4,2,2,8,0,0
21162,1,162,794.15,1,3,3,7,0,0
21163,43,128,685.87,4,3,2,9,1,1
21164,1,283,5179.58,1,4,4,9,1,1
21165,3,450,6959.36,2,4,4,10,1,1
21166,1,734,21118.74,1,4,4,9,1,1
21167,1,68,347.64,1,3,2,6,0,0
21169,1,455,7349.58,1,4,4,9,1,1
21171,121,73,613.14,4,3,2,9,1,1
21172,1,469,5364.73,1,4,4,9,1,1
21174,1,538,9413.82,1,4,4,9,1,1
21175,1,816,30849.4,1,4,4,9,1,1
21179,88,267,1320.11,4,4,3,11,1,1
21181,1,855,25460.280000000002,1,4,4,9,1,1
21186,360,1,6.72,4,1,1,6,0,0
21187,127,48,651.75,4,2,2,8,0,0
21188,129,50,1021.9000000000001,4,2,3,9,1,1
21189,1,72,888.67,1,3,3,7,0,0
21190,15,8,317.7,3,1,2,6,0,0
21191,2,95,1451.82,2,3,3,8,0,0
21192,12,88,1924.9399999999998,3,3,3,9,1,1
21194,1,68,564.57,1,3,2,6,0,0
21195,206,80,1308.56,4,3,3,10,1,1
21196,3,13,189.67999999999998,2,1,2,5,0,0
21197,8,28,417.60999999999996,3,2,2,7,0,0
21198,3,73,1068.2299999999998,2,3,3,8,0,0
21199,8,79,908.4899999999999,3,3,3,9,1,1
21200,1,75,1531.1399999999999,1,3,3,7,0,0
21201,1,102,2990.37,1,3,4,8,0,0
21202,23,25,487.11,3,2,2,7,0,0
21204,3,85,868.4399999999999,2,3,3,8,0,0
21205,7,71,728.1899999999999,3,3,3,9,1,1
21206,16,110,1614.22,3,3,3,9,1,1
21207,4,132,1686.4999999999998,3,3,3,9,1,1
21208,1,87,713.76,1,3,3,7,0,0
21209,1,94,894.5699999999999,1,3,3,7,0,0
21210,1,458,8547.84,1,4,4,9,1,1
21211,11,103,1271.52,3,3,3,9,1,1
21212,1,1334,21458.48,1,4,4,9,1,1
21213,1,664,8444.84,1,4,4,9,1,1
21215,2,124,745.45,2,3,3,8,0,0
21216,1,440,11486.06,1,4,4,9,1,1
21217,1,351,11621.939999999999,1,4,4,9,1,1
21218,1,405,10281.74,1,4,4,9,1,1
21219,2,89,561.84,2,3,2,7,0,0
21220,1,89,457.51,1,3,2,6,0,0
21221,2,54,340.22,2,2,2,6,0,0
21222,1,73,353.19,1,3,2,6,0,0
21224,1,167,1095.0,1,3,3,7,0,0
21226,15,20,81.8,3,2,1,6,0,0
21228,275,2,6.25,4,1,1,6,0,0
21231,1,536,7816.610000000001,1,4,4,9,1,1
21232,1,888,16707.05,1,4,4,9,1,1
21238,1,396,3531.66,1,4,4,9,1,1
21239,1,309,2726.89,1,4,4,9,1,1
21240,2,330,3143.15,2,4,4,10,1,1
21242,1,308,5763.929999999999,1,4,4,9,1,1
21243,1,211,3840.68,1,4,4,9,1,1
21244,4,199,3814.6699999999996,3,4,4,11,1,1
21245,3,128,1792.27,2,3,3,8,0,0
21246,96,98,1346.68,4,3,3,10,1,1
21248,1,67,332.16999999999996,1,3,2,6,0,0
21249,2,119,2160.0,2,3,3,8,0,0
21250,9,20,274.37,3,2,2,7,0,0
21251,9,46,568.98,3,2,2,7,0,0
21253,1,62,593.37,1,2,2,5,0,0
21257,1,266,6997.7699999999995,1,4,4,9,1,1
21258,1,181,8354.55,1,4,4,9,1,1
21259,1,293,7199.150000000001,1,4,4,9,1,1
21260,1,168,3861.98,1,4,4,9,1,1
21261,4,45,672.09,3,2,2,7,0,0
21262,2,81,1298.8100000000002,2,3,3,8,0,0
21263,3,43,360.87,2,2,2,6,0,0
21264,3,50,591.15,2,2,2,6,0,0
21265,2,19,267.21,2,2,2,6,0,0
21268,372,1,0.84,4,1,1,6,0,0
21269,17,19,254.98000000000002,3,2,2,7,0,0
21270,5,36,530.19,3,2,2,7,0,0
21272,121,105,786.3199999999999,4,3,3,10,1,1
21275,29,14,346.83,3,1,2,6,0,0
21277,16,24,615.3299999999999,3,2,2,7,0,0
21278,147,7,109.64999999999999,4,1,1,6,0,0
21279,5,30,273.79999999999995,3,2,2,7,0,0
21280,30,12,165.75,3,1,2,6,0,0
21281,30,14,129.63,3,1,1,5,0,0
21284,1,44,406.54,1,2,2,5,0,0
21285,1,44,429.48,1,2,2,5,0,0
21286,1,30,362.12,1,2,2,5,0,0
21287,4,55,760.15,3,2,3,8,0,0
21288,2,111,1131.46,2,3,3,8,0,0
21289,2,51,733.75,2,2,3,7,0,0
21291,11,52,819.64,3,2,3,8,0,0
21292,3,28,594.51,2,2,2,6,0,0
21293,4,24,276.72,3,2,2,7,0,0
21294,44,71,825.49,4,3,3,10,1,1
21306,5,46,200.35,3,2,2,7,0,0
21307,150,13,39.199999999999996,4,1,1,6,0,0
21310,199,1,29.95,4,1,1,6,0,0
21311,5,53,196.7,3,2,2,7,0,0
21313,1,224,2930.14,1,4,4,9,1,1
21314,1,581,10081.730000000001,1,4,4,9,1,1
21316,243,16,220.63000000000002,4,1,2,7,0,0
21317,4,35,694.48,3,2,2,7,0,0
21318,214,54,441.78999999999996,4,2,2,8,0,0
21319,243,20,177.42999999999998,4,2,2,8,0,0
21320,233,20,378.92,4,2,2,8,0,0
21324,214,28,259.67,4,2,2,8,0,0
21326,1,345,6904.12,1,4,4,9,1,1
21327,1,252,1484.1299999999999,1,4,3,8,0,0
21328,1,346,2418.68,1,4,4,9,1,1
21329,1,287,1728.6399999999999,1,4,3,8,0,0
21331,23,8,165.74,3,1,2,6,0,0
21332,116,13,268.1,4,1,2,7,0,0
21333,249,16,168.16000000000003,4,1,2,7,0,0
21336,163,10,54.57,4,1,1,6,0,0
21340,2,297,11636.47,2,4,4,10,1,1
21344,1,7,189.94,1,1,2,4,0,0
21348,318,6,361.55999999999995,4,1,2,7,0,0
21349,38,12,182.6,4,1,2,7,0,0
21351,1,36,720.13,1,2,3,6,0,0
21352,24,79,1572.0100000000002,3,3,3,9,1,1
21354,9,95,1010.21,3,3,3,9,1,1
21355,1,120,998.83,1,3,3,7,0,0
21356,1,151,704.55,1,3,3,7,0,0
21357,256,10,23.75,4,1,1,6,0,0
21358,2,108,494.54,2,3,2,7,0,0
21359,120,31,868.13,4,2,3,9,1,1
21360,186,16,236.17,4,1,2,7,0,0
21361,140,71,1556.96,4,3,3,10,1,1
21363,72,131,1483.14,4,3,3,10,1,1
21364,58,25,229.71,4,2,2,8,0,0
21365,1,52,447.09000000000003,1,2,2,5,0,0
21366,2,46,470.16999999999996,2,2,2,6,0,0
21367,4,43,199.48999999999998,3,2,2,7,0,0
21368,5,33,144.03,3,2,2,7,0,0
21369,5,16,161.49,3,1,2,6,0,0
21370,2,9,100.66000000000001,2,1,1,4,0,0
21371,1,38,319.71,1,2,2,5,0,0
21372,11,33,107.75,3,2,1,6,0,0
21373,2,48,398.04,2,2,2,6,0,0
21374,9,46,463.79,3,2,2,7,0,0
21375,6,27,315.27,3,2,2,7,0,0
21376,6,17,197.81,3,2,2,7,0,0
21377,2,41,215.67999999999998,2,2,2,6,0,0
21378,1,34,217.89,1,2,2,5,0,0
21379,1,50,254.32999999999998,1,2,2,5,0,0
21380,8,291,6319.31,3,4,4,11,1,1
21381,4,226,3180.25,3,4,4,11,1,1
21382,9,129,1395.08,3,3,3,9,1,1
21383,1,168,757.13,1,4,3,8,0,0
21385,2,318,3449.2499999999995,2,4,4,10,1,1
21386,6,51,290.2,3,2,2,7,0,0
21389,5,129,967.6299999999999,3,3,3,9,1,1
21390,2,213,4855.63,2,4,4,10,1,1
21391,19,107,1070.74,3,3,3,9,1,1
21392,267,7,46.39,4,1,1,6,0,0
21393,257,7,38.67,4,1,1,6,0,0
21394,27,135,1612.35,3,3,3,9,1,1
21395,36,93,1145.3,4,3,3,10,1,1
21397,214,65,550.43,4,2,2,8,0,0
21398,234,63,729.6,4,2,3,9,1,1
21399,188,74,917.5799999999999,4,3,3,10,1,1
21400,1,72,128.63,1,3,1,5,0,0
21401,1,82,151.19,1,3,2,6,0,0
21402,1,92,185.51999999999998,1,3,2,6,0,0
21403,1,106,322.18,1,3,2,6,0,0
21407,18,139,1425.36,3,3,3,9,1,1
21408,1,118,1303.71,1,3,3,7,0,0
21410,367,1,8.47,4,1,1,6,0,0
21411,1,242,3007.5299999999997,1,4,4,9,1,1
21412,339,1,2.52,4,1,1,6,0,0
21413,26,17,75.02,3,2,1,6,0,0
21414,290,1,2.1,4,1,1,6,0,0
21415,1,46,454.42,1,2,2,5,0,0
21416,262,4,18.75,4,1,1,6,0,0
21417,1,69,631.9,1,3,2,6,0,0
21418,2,25,189.75,2,2,2,6,0,0
21420,2,19,123.66,2,2,1,5,0,0
21421,199,14,348.43000000000006,4,1,2,7,0,0
21422,9,65,1298.3999999999999,3,2,3,8,0,0
21424,45,75,1415.77,4,3,3,10,1,1
21425,3,30,320.49,2,2,2,6,0,0
21426,5,49,632.98,3,2,2,7,0,0
21427,3,44,262.74,2,2,2,6,0,0
21428,3,268,5304.13,2,4,4,10,1,1
21429,1,295,3473.0499999999997,1,4,4,9,1,1
21430,1,489,12072.48,1,4,4,9,1,1
21439,1,131,2199.63,1,3,3,7,0,0
21441,1,62,292.03,1,2,2,5,0,0
21442,1,59,310.49,1,2,2,5,0,0
21445,140,22,272.5,4,2,2,8,0,0
21446,1,105,640.92,1,3,2,6,0,0
21447,79,149,1479.35,4,3,3,10,1,1
21448,55,77,600.8699999999999,4,3,2,9,1,1
21452,1,196,2632.26,1,4,4,9,1,1
21454,2,136,486.01,2,3,2,7,0,0
21455,2,118,527.8399999999999,2,3,2,7,0,0
21456,2,26,223.47,2,2,2,6,0,0
21457,30,25,165.89,3,2,2,7,0,0
21458,30,36,256.54,3,2,2,7,0,0
21459,17,21,165.98,3,2,2,7,0,0
21460,262,11,56.779999999999994,4,1,1,6,0,0
21461,17,8,29.71,3,1,1,5,0,0
21462,1,73,932.4,1,3,3,7,0,0
21463,3,142,3663.8500000000004,2,3,4,9,1,1
21464,8,109,1093.5,3,3,3,9,1,1
21465,8,79,897.8,3,3,3,9,1,1
21466,1,112,1116.89,1,3,3,7,0,0
21467,1,106,1011.89,1,3,3,7,0,0
21468,10,66,572.23,3,3,2,8,0,0
21469,3,91,1092.82,2,3,3,8,0,0
21470,2,142,1496.57,2,3,3,8,0,0
21471,1,166,2243.09,1,3,3,7,0,0
21472,147,37,476.41,4,2,2,8,0,0
21473,19,21,618.66,3,2,2,7,0,0
21476,51,24,699.63,4,2,3,9,1,1
21479,1,503,21230.38,1,4,4,9,1,1
21481,1,497,11705.970000000001,1,4,4,9,1,1
21484,1,404,8683.12,1,4,4,9,1,1
21485,1,631,17807.530000000002,1,4,4,9,1,1
21486,367,11,147.88,4,1,2,7,0,0
21488,284,16,566.1700000000001,4,1,2,7,0,0
21491,358,1,1.95,4,1,1,6,0,0
21494,1,314,3581.33,1,4,4,9,1,1
21495,1,166,2366.5,1,3,4,8,0,0
21497,1,230,3430.0,1,4,4,9,1,1
21498,1,338,4343.42,1,4,4,9,1,1
21499,2,219,2902.34,2,4,4,10,1,1
21500,5,213,2593.0,3,4,4,11,1,1
21503,9,24,289.34,3,2,2,7,0,0
21504,2,115,788.97,2,3,3,8,0,0
21506,1,324,2106.05,1,4,3,8,0,0
21507,1,264,1435.36,1,4,3,8,0,0
21508,1,214,1052.02,1,4,3,8,0,0
21509,1,274,1572.28,1,4,3,8,0,0
21518,150,38,132.44,4,2,2,8,0,0
21519,1,249,1404.34,1,4,3,8,0,0
21520,4,59,215.03,3,2,2,7,0,0
21523,1,505,21641.74,1,4,4,9,1,1
21524,1,483,13661.31,1,4,4,9,1,1
21527,208,165,4017.09,4,3,4,11,1,1
21528,1,121,1671.72,1,3,3,7,0,0
21530,1,112,817.7600000000001,1,3,3,7,0,0
21531,2,257,3728.82,2,4,4,10,1,1
21533,1,350,6849.120000000001,1,4,4,9,1,1
21534,3,163,1973.23,2,3,3,8,0,0
21535,1,359,6092.21,1,4,4,9,1,1
21537,3,68,1600.96,2,3,3,8,0,0
21538,365,2,18.75,4,1,1,6,0,0
21539,26,254,4867.7,3,4,4,11,1,1
21544,1,174,1690.23,1,4,3,8,0,0
21547,262,22,253.53000000000003,4,2,2,8,0,0
21555,3,69,350.46999999999997,2,3,2,7,0,0
21556,17,115,2518.07,3,3,4,10,1,1
21557,1,162,1843.6100000000001,1,3,3,7,0,0
21558,1,416,5578.2699999999995,1,4,4,9,1,1
21559,1,583,9783.38,1,4,4,9,1,1
21561,1,215,3132.48,1,4,4,9,1,1
21562,18,28,380.36,3,2,2,7,0,0
21563,1,159,2803.13,1,3,4,8,0,0
21564,1,126,1839.67,1,3,3,7,0,0
21576,2,78,585.34,2,3,2,7,0,0
21577,1,177,1680.6499999999999,1,4,3,8,0,0
21578,5,128,1669.01,3,3,3,9,1,1
21579,4,53,436.72,3,2,2,7,0,0
21580,2,62,444.07,2,2,2,6,0,0
21581,2,80,617.67,2,3,2,7,0,0
21584,3,147,1756.55,2,3,3,8,0,0
21586,33,69,1755.0,4,3,3,10,1,1
21587,53,26,480.75,4,2,2,8,0,0
21588,2,133,3452.7,2,3,4,9,1,1
21591,1,148,2068.64,1,3,3,7,0,0
21592,1,216,2164.46,1,4,3,8,0,0
21594,329,2,8.34,4,1,1,6,0,0
21595,367,2,16.94,4,1,1,6,0,0
21609,101,76,2089.64,4,3,3,10,1,1
21613,43,42,661.9300000000001,4,2,2,8,0,0
21614,193,9,153.29000000000002,4,1,2,7,0,0
21615,1,135,1349.17,1,3,3,7,0,0
21616,1,138,1288.34,1,3,3,7,0,0
21617,18,102,1013.01,3,3,3,9,1,1
21618,25,91,770.87,3,3,3,9,1,1
21619,1,164,1481.4,1,3,3,7,0,0
21620,1,165,1451.99,1,3,3,7,0,0
21621,3,479,24780.83,2,4,4,10,1,1
21622,2,110,2101.44,2,3,3,8,0,0
21623,1,225,23049.89,1,4,4,9,1,1
21624,1,97,1367.26,1,3,3,7,0,0
21625,2,169,2967.31,2,4,4,10,1,1
21626,18,104,1629.6499999999999,3,3,3,9,1,1
21627,46,47,1299.83,4,2,3,9,1,1
21628,2,34,1206.5,2,2,3,7,0,0
21629,1,42,687.95,1,2,2,5,0,0
21630,3,36,727.09,2,2,3,7,0,0
21631,22,27,896.01,3,2,3,8,0,0
21632,325,24,489.74,4,2,2,8,0,0
21633,19,43,908.21,3,2,3,8,0,0
21634,54,28,481.95,4,2,2,8,0,0
21635,150,16,374.96000000000004,4,1,2,7,0,0
21636,4,73,709.66,3,3,3,9,1,1
21637,60,6,136.25,4,1,2,7,0,0
21638,1,40,551.96,1,2,2,5,0,0
21640,1,78,644.03,1,3,2,6,0,0
21641,84,49,451.59,4,2,2,8,0,0
21642,1,107,877.56,1,3,3,7,0,0
21643,24,61,758.31,3,2,3,8,0,0
21644,12,34,300.0,3,2,2,7,0,0
21645,337,1,39.599999999999994,4,1,1,6,0,0
21647,13,26,249.90000000000003,3,2,2,7,0,0
21648,1,67,994.04,1,3,3,7,0,0
21650,1,133,697.41,1,3,3,7,0,0
21651,291,11,208.46999999999997,4,1,2,7,0,0
21654,83,59,509.36,4,2,2,8,0,0
21655,301,5,121.68,4,1,1,6,0,0
21656,220,47,444.58,4,2,2,8,0,0
21657,292,17,223.46,4,2,2,8,0,0
21658,57,236,3846.21,4,4,4,12,1,1
21661,290,3,17.85,4,1,1,6,0,0
21662,116,26,557.3000000000001,4,2,2,8,0,0
21664,54,18,353.97,4,2,2,8,0,0
21666,4,43,283.51,3,2,2,7,0,0
21667,327,2,59.8,4,1,1,6,0,0
21668,1,447,7630.33,1,4,4,9,1,1
21669,1,435,7251.01,1,4,4,9,1,1
21670,1,381,6237.54,1,4,4,9,1,1
21671,1,383,6293.35,1,4,4,9,1,1
21672,1,416,6893.45,1,4,4,9,1,1
21673,1,373,6215.7,1,4,4,9,1,1
21675,1,111,583.56,1,3,2,6,0,0
21676,4,61,245.35999999999999,3,2,2,7,0,0
21677,1,120,748.04,1,3,3,7,0,0
21678,1,32,111.86,1,2,1,4,0,0
21679,2,138,1028.58,2,3,3,8,0,0
21680,1,103,786.31,1,3,3,7,0,0
21681,290,2,19.9,4,1,1,6,0,0
21682,5,56,945.8100000000001,3,2,3,8,0,0
21683,4,58,948.7000000000002,3,2,3,8,0,0
21684,1,47,622.3,1,2,2,5,0,0
21686,68,21,1391.5900000000001,4,2,3,9,1,1
21688,10,57,1101.2800000000002,3,2,3,8,0,0
21689,4,26,369.87,3,2,2,7,0,0
21690,313,7,90.0,4,1,1,6,0,0
21692,288,7,63.75,4,1,1,6,0,0
21693,4,50,1143.3100000000002,3,2,3,8,0,0
21694,4,24,840.33,3,2,3,8,0,0
21695,2,41,875.3800000000001,2,2,3,7,0,0
21696,16,34,725.5000000000001,3,2,3,8,0,0
21698,2,45,164.17,2,2,2,6,0,0
21700,2,199,2365.54,2,4,4,10,1,1
21703,1,300,3565.4300000000003,1,4,4,9,1,1
21704,1,251,4043.14,1,4,4,9,1,1
21705,1,144,1493.77,1,3,3,7,0,0
21706,3,120,1621.76,2,3,3,8,0,0
21707,4,74,763.6600000000001,3,3,3,9,1,1
21708,4,65,873.01,3,2,3,8,0,0
21709,5,59,607.23,3,2,2,7,0,0
21710,15,45,501.98,3,2,2,7,0,0
21711,15,36,513.02,3,2,2,7,0,0
21713,3,162,1868.99,2,3,3,8,0,0
21714,1,230,3043.15,1,4,4,9,1,1
21715,1,231,3507.17,1,4,4,9,1,1
21716,1,245,3934.12,1,4,4,9,1,1
21717,263,41,946.93,4,2,3,9,1,1
21718,1,230,2115.89,1,4,3,8,0,0
21719,4,58,307.44,3,2,2,7,0,0
21720,137,8,48.449999999999996,4,1,1,6,0,0
21721,7,33,179.45999999999998,3,2,2,7,0,0
21722,2,37,96.38,2,2,1,5,0,0
21723,4,59,353.47999999999996,3,2,2,7,0,0
21724,1,81,355.83,1,3,2,6,0,0
21725,22,50,277.24,3,2,2,7,0,0
21726,2,42,204.69,2,2,2,6,0,0
21730,2,139,2587.98,2,3,4,9,1,1
21731,1,861,24214.28,1,4,4,9,1,1
21733,1,754,23381.690000000002,1,4,4,9,1,1
21735,84,96,2960.4,4,3,4,11,1,1
21736,239,6,138.39000000000001,4,1,2,7,0,0
21738,51,21,150.48000000000002,4,2,2,8,0,0
21739,1,111,708.98,1,3,3,7,0,0
21741,24,40,480.1700000000001,3,2,2,7,0,0
21742,1,91,1173.53,1,3,3,7,0,0
21743,88,51,917.1500000000001,4,2,3,9,1,1
21744,15,127,1563.5500000000002,3,3,3,9,1,1
21745,3,215,3501.98,2,4,4,10,1,1
21746,11,229,3785.68,3,4,4,11,1,1
21747,9,55,660.61,3,2,2,7,0,0
21749,10,143,3893.8900000000003,3,3,4,10,1,1
21750,31,24,209.61,3,2,2,7,0,0
21754,1,787,17168.52,1,4,4,9,1,1
21755,1,631,12596.51,1,4,4,9,1,1
21756,1,271,5101.46,1,4,4,9,1,1
21757,296,3,29.700000000000003,4,1,1,6,0,0
21758,8,32,427.46000000000004,3,2,2,7,0,0
21761,5,10,299.5,3,1,2,6,0,0
21763,156,4,169.75,4,1,2,7,0,0
21769,367,2,607.6500000000001,4,1,2,7,0,0
21770,1,389,7968.4800000000005,1,4,4,9,1,1
21773,2,163,1154.17,2,3,3,8,0,0
21774,1,187,1153.65,1,4,3,8,0,0
21775,1,140,720.61,1,3,3,7,0,0
21777,365,8,135.15,4,1,2,7,0,0
21781,152,109,2959.9,4,3,4,11,1,1
21784,99,45,652.9699999999999,4,2,2,8,0,0
21785,297,5,269.61,4,1,2,7,0,0
21786,1,227,927.49,1,4,3,8,0,0
21787,1,246,7583.65,1,4,4,9,1,1
21788,4,88,1051.1399999999999,3,3,3,9,1,1
21789,7,94,823.1999999999999,3,3,3,9,1,1
21790,1,929,12588.21,1,4,4,9,1,1
21791,1,610,10580.65,1,4,4,9,1,1
21792,128,78,1555.67,4,3,3,10,1,1
21793,8,74,1296.6100000000001,3,3,3,9,1,1
21794,45,108,2225.27,4,3,3,10,1,1
21801,41,126,545.38,4,3,2,9,1,1
21802,19,181,920.8199999999999,3,4,3,10,1,1
21803,1,198,1031.56,1,4,3,8,0,0
21804,8,65,830.03,3,2,3,8,0,0
21807,17,30,189.42,3,2,2,7,0,0
21808,1,48,641.58,1,2,2,5,0,0
21809,1,117,1119.56,1,3,3,7,0,0
21810,1,254,3096.54,1,4,4,9,1,1
21811,17,246,2706.12,3,4,4,11,1,1
21812,1,103,1820.5200000000002,1,3,3,7,0,0
21813,1,114,2315.1200000000003,1,3,4,8,0,0
21814,11,15,117.57,3,1,1,5,0,0
21815,16,29,271.68,3,2,2,7,0,0
21816,12,7,49.3,3,1,1,5,0,0
21817,30,58,414.63,3,2,2,7,0,0
21818,2,163,1322.5,2,3,3,8,0,0
21819,1,124,1067.82,1,3,3,7,0,0
21820,4,93,1492.22,3,3,3,9,1,1
21821,5,63,1082.05,3,2,3,8,0,0
21822,1,99,764.13,1,3,3,7,0,0
21823,25,97,854.74,3,3,3,9,1,1
21824,25,118,1137.61,3,3,3,9,1,1
21826,268,36,191.43,4,2,2,8,0,0
21827,255,3,7.5,4,1,1,6,0,0
21828,1,84,439.54,1,3,2,6,0,0
21829,51,178,1506.1,4,4,3,11,1,1
21830,16,101,1147.39,3,3,3,9,1,1
21832,1,199,1841.2499999999998,1,4,3,8,0,0
21833,1,171,4645.13,1,4,4,9,1,1
21836,323,3,26.490000000000002,4,1,1,6,0,0
21839,257,1,5.45,4,1,1,6,0,0
21841,11,21,314.5,3,2,2,7,0,0
21843,1,581,23845.75,1,4,4,9,1,1
21844,3,167,5229.24,2,3,4,9,1,1
21845,12,90,1796.73,3,3,3,9,1,1
21846,1,104,1266.37,1,3,3,7,0,0
21847,23,33,178.89,3,2,2,7,0,0
21849,5,66,558.83,3,3,2,8,0,0
21850,3,55,646.08,2,2,2,6,0,0
21851,4,63,454.99,3,2,2,7,0,0
21864,1,185,2085.79,1,4,3,8,0,0
21865,2,106,625.23,2,3,2,7,0,0
21866,2,193,1296.13,2,4,3,9,1,1
21867,1,121,486.5,1,3,2,6,0,0
21868,4,312,3361.66,3,4,4,11,1,1
21870,108,166,1893.96,4,3,3,10,1,1
21871,1,369,7422.150000000001,1,4,4,9,1,1
21872,1,144,1477.7,1,3,3,7,0,0
21873,1,120,1938.12,1,3,3,7,0,0
21874,1,302,4177.64,1,4,4,9,1,1
21875,1,153,2464.38,1,3,4,8,0,0
21876,1,341,4893.41,1,4,4,9,1,1
21877,1,364,8076.65,1,4,4,9,1,1
21878,1,226,2184.1,1,4,3,8,0,0
21879,1,94,386.77000000000004,1,3,2,6,0,0
21880,2,241,866.58,2,4,3,9,1,1
21881,2,79,383.11,2,3,2,7,0,0
21882,11,70,252.47000000000003,3,3,2,8,0,0
21883,2,134,725.61,2,3,3,8,0,0
21884,6,93,413.76,3,3,2,8,0,0
21888,5,383,6723.29,3,4,4,11,1,1
21889,1,589,8894.79,1,4,4,9,1,1
21890,1,236,3707.86,1,4,4,9,1,1
21891,1,431,10585.32,1,4,4,9,1,1
21892,1,414,4338.41,1,4,4,9,1,1
21894,1,130,908.33,1,3,3,7,0,0
21895,365,2,12.72,4,1,1,6,0,0
21896,4,113,2288.84,3,3,3,9,1,1
21897,227,3,1268.1899999999998,4,1,3,8,0,0
21898,227,25,1541.11,4,2,3,9,1,1
21899,1,282,1789.17,1,4,3,8,0,0
21900,1,374,2204.32,1,4,3,8,0,0
21901,1,309,1286.3400000000001,1,4,3,8,0,0
21902,1,212,1276.67,1,4,3,8,0,0
21903,1,182,2521.63,1,4,4,9,1,1
21904,198,23,107.10000000000001,4,2,1,7,0,0
21905,1,160,823.71,1,3,3,7,0,0
21906,1,179,4585.5599999999995,1,4,4,9,1,1
21907,2,369,5058.68,2,4,4,10,1,1
21908,1,471,7811.02,1,4,4,9,1,1
21910,296,8,59.39999999999999,4,1,1,6,0,0
21911,239,30,223.00999999999996,4,2,2,8,0,0
21912,1,396,7062.7,1,4,4,9,1,1
21913,2,150,1577.08,2,3,3,8,0,0
21914,1,605,10388.56,1,4,4,9,1,1
21915,2,670,26415.33,2,4,4,10,1,1
21916,1,360,1983.99,1,4,3,8,0,0
21917,1,227,1709.49,1,4,3,8,0,0
21918,1,372,2957.39,1,4,4,9,1,1
21922,2,208,6952.31,2,4,4,10,1,1
21925,3,69,511.25,2,3,2,7,0,0
21926,2,62,527.4,2,2,2,6,0,0
21927,8,107,819.9,3,3,3,9,1,1
21928,1,816,21639.08,1,4,4,9,1,1
21929,1,877,23568.21,1,4,4,9,1,1
21930,1,708,14037.4,1,4,4,9,1,1
21931,1,1201,31372.45,1,4,4,9,1,1
21932,1,449,5057.33,1,4,4,9,1,1
21933,1,414,4998.48,1,4,4,9,1,1
21934,1,412,4496.78,1,4,4,9,1,1
21935,1,531,6300.26,1,4,4,9,1,1
21936,1,543,11828.19,1,4,4,9,1,1
21937,6,257,4949.0,3,4,4,11,1,1
21942,1,104,323.21,1,3,2,6,0,0
21943,2,50,134.48999999999998,2,2,2,6,0,0
21944,1,100,310.19,1,3,2,6,0,0
21945,1,105,373.34,1,3,2,6,0,0
21946,2,25,75.35,2,2,1,5,0,0
21947,1,152,1142.15,1,3,3,7,0,0
21948,3,153,979.48,2,3,3,8,0,0
21949,1,144,1054.44,1,3,3,7,0,0
21955,1,206,7597.02,1,4,4,9,1,1
21967,1,232,1583.4099999999999,1,4,3,8,0,0
21972,8,67,501.97999999999996,3,3,2,8,0,0
21973,12,31,231.99999999999997,3,2,2,7,0,0
21974,2,366,3634.0499999999997,2,4,4,10,1,1
21975,2,604,6153.97,2,4,4,10,1,1
21976,1,395,2902.9,1,4,4,9,1,1
21977,1,875,12300.57,1,4,4,9,1,1
21980,1,300,2160.04,1,4,3,8,0,0
21981,1,272,1658.09,1,4,3,8,0,0
21982,1,360,2304.5299999999997,1,4,4,9,1,1
21983,1,156,784.63,1,3,3,7,0,0
21984,1,214,1134.35,1,4,3,8,0,0
21985,1,427,2737.6299999999997,1,4,4,9,1,1
21986,1,189,1197.73,1,4,3,8,0,0
21987,1,173,1355.1000000000001,1,4,3,8,0,0
21988,3,193,1862.75,2,4,3,9,1,1
21989,1,335,2235.65,1,4,3,8,0,0
21990,1,367,2895.45,1,4,4,9,1,1
21991,1,212,1095.82,1,4,3,8,0,0
21992,24,436,3529.12,3,4,4,11,1,1
21993,1,426,3378.34,1,4,4,9,1,1
22016,129,1,83.33,4,1,1,6,0,0
22021,264,71,610.4499999999999,4,3,2,9,1,1
22023,2,147,548.8,2,3,2,7,0,0
22024,1,214,1038.85,1,4,3,8,0,0
22025,1,131,771.13,1,3,3,7,0,0
22026,1,161,722.16,1,3,3,7,0,0
22027,1,365,1945.71,1,4,3,8,0,0
22028,1,263,1314.22,1,4,3,8,0,0
22029,1,528,3402.69,1,4,4,9,1,1
22030,1,274,2247.97,1,4,3,8,0,0
22031,1,81,230.63,1,3,2,6,0,0
22032,15,60,181.98,3,2,2,7,0,0
22033,17,22,141.95,3,2,2,7,0,0
22034,14,5,10.059999999999999,3,1,1,5,0,0
22035,39,137,622.36,4,3,2,9,1,1
22037,1,354,1715.48,1,4,3,8,0,0
22038,4,19,199.5,3,2,2,7,0,0
22039,45,8,115.5,4,1,1,6,0,0
22040,23,28,304.5,3,2,2,7,0,0
22041,1,365,11448.31,1,4,4,9,1,1
22042,4,40,178.41,3,2,2,7,0,0
22043,7,64,304.5,3,2,2,7,0,0
22044,33,36,196.44,4,2,2,8,0,0
22045,2,211,2715.34,2,4,4,10,1,1
22046,2,77,943.28,2,3,3,8,0,0
22047,4,107,1405.0,3,3,3,9,1,1
22048,4,33,404.0,3,2,2,7,0,0
22049,51,34,306.75,4,2,2,8,0,0
22050,4,41,509.0,3,2,2,7,0,0
22051,15,39,420.0,3,2,2,7,0,0
22052,151,29,294.0,4,2,2,8,0,0
22053,31,29,3607.6699999999996,3,2,4,9,1,1
22055,1,227,2124.24,1,4,3,8,0,0
22057,1,65,739.44,1,2,3,6,0,0
22059,1,181,2130.0,1,4,3,8,0,0
22060,200,40,1206.15,4,2,3,9,1,1
22061,1,161,4377.0599999999995,1,3,4,8,0,0
22062,57,74,686.99,4,3,2,9,1,1
22063,2,125,1405.8,2,3,3,8,0,0
22064,1,255,2613.7999999999997,1,4,4,9,1,1
22065,1,249,3492.85,1,4,4,9,1,1
22066,3,137,1053.0,2,3,3,8,0,0
22067,1,73,654.3199999999999,1,3,2,6,0,0
22068,1,145,884.8299999999999,1,3,3,7,0,0
22069,1,146,996.8,1,3,3,7,0,0
22070,1,121,2694.69,1,3,4,8,0,0
22071,1,91,1568.55,1,3,3,7,0,0
22072,1,171,2902.42,1,4,4,9,1,1
22073,219,71,1388.64,4,3,3,10,1,1
22074,1,200,1261.12,1,4,3,8,0,0
22075,1,201,2523.14,1,4,4,9,1,1
22076,1,225,1669.5299999999997,1,4,3,8,0,0
22077,1,961,17261.469999999998,1,4,4,9,1,1
22078,1,192,2948.41,1,4,4,9,1,1
22079,2,326,3397.89,2,4,4,10,1,1
22080,1,156,2044.73,1,3,3,7,0,0
22081,1,139,1209.5,1,3,3,7,0,0
22082,2,411,4749.33,2,4,4,10,1,1
22083,1,615,14324.740000000002,1,4,4,9,1,1
22084,1,438,15243.92,1,4,4,9,1,1
22085,1,97,1566.99,1,3,3,7,0,0
22086,1,1170,66112.64,1,4,4,9,1,1
22087,1,334,12117.03,1,4,4,9,1,1
22088,157,241,5810.25,4,4,4,12,1,1
22089,5,272,4460.38,3,4,4,11,1,1
22090,2,805,22987.36,2,4,4,10,1,1
22091,1,168,1041.97,1,4,3,8,0,0
22092,2,91,322.18,2,3,2,7,0,0
22093,3,161,839.08,2,3,3,8,0,0
22094,1,205,1178.17,1,4,3,8,0,0
22095,1,145,1621.47,1,3,3,7,0,0
22096,1,118,589.1600000000001,1,3,2,6,0,0
22097,1,146,743.47,1,3,3,7,0,0
22098,1,178,1033.3,1,4,3,8,0,0
22099,1,154,815.9,1,3,3,7,0,0
22100,4,59,356.46000000000004,3,2,2,7,0,0
22101,1,70,2179.53,1,3,3,7,0,0
22102,11,32,1112.64,3,2,3,8,0,0
22103,46,29,1129.7,4,2,3,9,1,1
22104,1,59,343.71,1,2,2,5,0,0
22105,2,34,1075.82,2,2,3,7,0,0
22106,1,49,1055.13,1,2,3,6,0,0
22107,1,183,2234.31,1,4,3,8,0,0
22108,1,63,415.09000000000003,1,2,2,5,0,0
22109,1,301,7043.04,1,4,4,9,1,1
22110,1,280,4919.79,1,4,4,9,1,1
22111,1,778,25054.29,1,4,4,9,1,1
22112,1,866,33415.06,1,4,4,9,1,1
22113,1,565,12909.58,1,4,4,9,1,1
22114,1,648,33312.69,1,4,4,9,1,1
22115,1,228,2020.91,1,4,3,8,0,0
22116,1,149,630.62,1,3,2,6,0,0
22117,3,95,3896.4500000000003,2,3,4,9,1,1
22118,1,89,901.46,1,3,3,7,0,0
22119,1,107,1773.52,1,3,3,7,0,0
22120,4,190,5396.34,3,4,4,11,1,1
22121,1,134,2171.6,1,3,3,7,0,0
22123,1,122,1069.1699999999998,1,3,3,7,0,0
22124,1,76,309.11,1,3,2,6,0,0
22125,16,3,139.86,3,1,2,6,0,0
22127,262,22,504.88,4,2,2,8,0,0
22128,3,79,2197.53,2,3,3,8,0,0
22129,1,100,1231.52,1,3,3,7,0,0
22130,1,112,2769.16,1,3,4,8,0,0
22131,2,292,3954.14,2,4,4,10,1,1
22132,1,155,949.2299999999999,1,3,3,7,0,0
22133,2,133,770.73,2,3,3,8,0,0
22134,1,162,419.42,1,3,2,6,0,0
22135,1,179,322.8,1,4,2,7,0,0
22136,2,85,682.38,2,3,2,7,0,0
22137,121,14,237.98000000000002,4,1,2,7,0,0
22138,1,961,24550.82,1,4,4,9,1,1
22139,1,978,23108.11,1,4,4,9,1,1
22141,1,461,6507.89,1,4,4,9,1,1
22142,1,379,4966.49,1,4,4,9,1,1
22144,1,547,9773.58,1,4,4,9,1,1
22145,366,1,63.0,4,1,1,6,0,0
22146,318,1,1.95,4,1,1,6,0,0
22147,9,489,9730.59,3,4,4,11,1,1
22148,6,188,3958.4,3,4,4,11,1,1
22149,29,556,13532.18,3,4,4,11,1,1
22150,1,472,5946.84,1,4,4,9,1,1
22151,1,337,6654.25,1,4,4,9,1,1
22152,5,107,1055.18,3,3,3,9,1,1
22153,1,134,1163.65,1,3,3,7,0,0
22154,1,165,1641.29,1,3,3,7,0,0
22155,1,143,1154.61,1,3,3,7,0,0
22156,1,269,2203.04,1,4,3,8,0,0
22157,100,11,180.2,4,1,2,7,0,0
22158,1,311,12016.630000000001,1,4,4,9,1,1
22161,1,341,1651.72,1,4,3,8,0,0
22162,16,93,873.69,3,3,3,9,1,1
22163,1,124,1062.53,1,3,3,7,0,0
22164,12,15,250.22000000000003,3,1,2,6,0,0
22165,1,147,3340.95,1,3,4,8,0,0
22166,2,89,1638.25,2,3,3,8,0,0
22167,1,159,2450.8199999999997,1,3,4,8,0,0
22168,242,85,1315.8,4,3,3,10,1,1
22169,1,389,10611.81,1,4,4,9,1,1
22170,1,270,7096.25,1,4,4,9,1,1
22171,1,398,14622.460000000001,1,4,4,9,1,1
22173,1,499,8053.47,1,4,4,9,1,1
22174,1,321,6013.429999999999,1,4,4,9,1,1
22175,1,173,2606.03,1,4,4,9,1,1
22176,40,117,1545.7300000000002,4,3,3,10,1,1
22178,1,1062,33826.37,1,4,4,9,1,1
22179,1,295,7411.9,1,4,4,9,1,1
22180,33,167,3755.99,4,3,4,11,1,1
22181,10,59,523.86,3,2,2,7,0,0
22182,1,124,1445.33,1,3,3,7,0,0
22183,27,131,1924.96,3,3,3,9,1,1
22184,317,37,488.86,4,2,2,8,0,0
22185,1,162,2291.4399999999996,1,3,3,7,0,0
22186,1,153,2129.63,1,3,3,7,0,0
22187,1,195,3260.3799999999997,1,4,4,9,1,1
22188,1,190,12491.12,1,4,4,9,1,1
22189,1,529,23495.07,1,4,4,9,1,1
22190,1,116,1057.71,1,3,3,7,0,0
22191,1,431,14624.85,1,4,4,9,1,1
22192,1,372,8357.59,1,4,4,9,1,1
22193,1,469,12075.52,1,4,4,9,1,1
22194,121,45,642.6899999999999,4,2,2,8,0,0
22195,1,374,3727.2599999999998,1,4,4,9,1,1
22196,1,476,2783.39,1,4,4,9,1,1
22197,1,1442,51720.57,1,4,4,9,1,1
22198,223,101,1940.26,4,3,3,10,1,1
22199,1,169,1961.84,1,4,3,8,0,0
22200,1,141,1824.48,1,3,3,7,0,0
22201,1,89,725.3,1,3,3,7,0,0
22202,218,38,323.1,4,2,2,8,0,0
22203,1,147,1490.63,1,3,3,7,0,0
22204,1,81,688.29,1,3,2,6,0,0
22206,18,5,4.17,3,1,1,5,0,0
22207,1,212,6120.09,1,4,4,9,1,1
22208,1,282,1588.08,1,4,3,8,0,0
22209,1,174,978.3299999999999,1,4,3,8,0,0
22210,1,187,959.6999999999999,1,4,3,8,0,0
22211,1,197,1193.6399999999999,1,4,3,8,0,0
22212,1,407,3763.94,1,4,4,9,1,1
22214,3,56,416.59999999999997,2,2,2,6,0,0
22215,1,103,2488.39,1,3,4,8,0,0
22216,1,68,512.93,1,3,2,6,0,0
22217,1,83,882.51,1,3,3,7,0,0
22218,359,1,4.25,4,1,1,6,0,0
22219,1,547,4060.08,1,4,4,9,1,1
22220,1,95,2060.7,1,3,3,7,0,0
22221,2,53,1124.44,2,2,3,7,0,0
22222,1,222,3880.2,1,4,4,9,1,1
22223,3,78,1821.6100000000001,2,3,3,8,0,0
22224,1,166,2778.8100000000004,1,3,4,8,0,0
22227,1,291,1709.3700000000001,1,4,3,8,0,0
22228,1,148,780.3299999999999,1,3,3,7,0,0
22229,5,102,434.15999999999997,3,3,2,8,0,0
22230,5,105,494.44999999999993,3,3,2,8,0,0
22231,1,153,1124.81,1,3,3,7,0,0
22232,2,88,659.18,2,3,2,7,0,0
22233,2,109,641.3199999999999,2,3,2,7,0,0
22236,16,99,4133.549999999999,3,3,4,10,1,1
22241,17,242,2646.7400000000002,3,4,4,11,1,1
22242,297,37,1050.4799999999998,4,2,3,9,1,1
22243,10,134,4771.44,3,3,4,10,1,1
22244,43,167,3311.31,4,3,4,11,1,1
22245,99,100,1075.1,4,3,3,10,1,1
22246,16,91,986.17,3,3,3,9,1,1
22247,14,113,593.14,3,3,2,8,0,0
22248,4,111,542.9399999999999,3,3,2,8,0,0
22249,2,146,829.86,2,3,3,8,0,0
22250,1,148,736.05,1,3,3,7,0,0
22251,1,140,911.99,1,3,3,7,0,0
22252,1,68,777.82,1,3,3,7,0,0
22254,2,61,836.8000000000001,2,2,3,7,0,0
22255,2,77,602.63,2,3,2,7,0,0
22256,93,50,394.15,4,2,2,8,0,0
22257,41,42,280.42,4,2,2,8,0,0
22258,14,79,752.64,3,3,3,9,1,1
22259,227,44,332.84,4,2,2,8,0,0
22260,1,105,580.8399999999999,1,3,2,6,0,0
22261,1,108,553.2099999999999,1,3,2,6,0,0
22262,3,139,958.1099999999999,2,3,3,8,0,0
22263,2,52,229.16,2,2,2,6,0,0
22264,1,96,738.68,1,3,3,7,0,0
22265,10,64,366.15000000000003,3,2,2,7,0,0
22266,2,92,596.5,2,3,2,7,0,0
22267,4,83,673.17,3,3,2,8,0,0
22268,29,160,812.3,3,3,3,9,1,1
22269,2,125,622.74,2,3,2,7,0,0
22270,17,56,971.84,3,2,3,8,0,0
22271,15,303,5045.700000000001,3,4,4,11,1,1
22272,202,49,567.87,4,2,2,8,0,0
22273,1,336,15528.99,1,4,4,9,1,1
22274,2,269,3994.78,2,4,4,10,1,1
22275,372,1,527.85,4,1,2,7,0,0
22276,1,87,856.7099999999999,1,3,3,7,0,0
22277,1,100,897.74,1,3,3,7,0,0
22278,1,181,2739.0,1,4,4,9,1,1
22279,1,129,1008.4,1,3,3,7,0,0
22280,1,95,510.84,1,3,2,6,0,0
22281,2,63,935.39,2,2,3,7,0,0
22282,1,100,2391.27,1,3,4,8,0,0
22283,1,157,2774.13,1,3,4,8,0,0
22284,4,133,1663.0699999999997,3,3,3,9,1,1
22285,4,120,1494.8999999999999,3,3,3,9,1,1
22286,9,115,1065.3899999999999,3,3,3,9,1,1
22287,9,81,724.8399999999999,3,3,3,9,1,1
22288,4,58,618.2,3,2,2,7,0,0
22289,18,34,198.52,3,2,2,7,0,0
22291,14,121,1981.4199999999998,3,3,3,9,1,1
22292,14,112,1608.86,3,3,3,9,1,1
22293,18,122,1341.6699999999998,3,3,3,9,1,1
22294,1,302,6943.83,1,4,4,9,1,1
22295,1,251,4663.469999999999,1,4,4,9,1,1
22296,2,319,5275.7699999999995,2,4,4,10,1,1
22297,2,378,5468.66,2,4,4,10,1,1
22299,1,83,1451.97,1,3,3,7,0,0
22300,1,201,3478.06,1,4,4,9,1,1
22301,1,263,5091.23,1,4,4,9,1,1
22302,1,215,5167.44,1,4,4,9,1,1
22303,1,271,6524.7,1,4,4,9,1,1
22304,1,61,1368.18,1,2,3,6,0,0
22305,2,52,1607.13,2,2,3,7,0,0
22306,4,115,1457.27,3,3,3,9,1,1
22307,1,79,1015.5400000000001,1,3,3,7,0,0
22308,1,105,877.38,1,3,3,7,0,0
22309,1,121,1093.6,1,3,3,7,0,0
22310,1,109,1296.23,1,3,3,7,0,0
22311,3,144,3439.16,2,3,4,9,1,1
22312,2,133,2038.9900000000002,2,3,3,8,0,0
22313,1,66,2202.33,1,3,3,7,0,0
22314,1,134,1767.9700000000003,1,3,3,7,0,0
22315,2,172,1221.43,2,4,3,9,1,1
22316,3,56,744.87,2,2,3,7,0,0
22317,11,89,882.6200000000001,3,3,3,9,1,1
22318,4,144,1562.2700000000002,3,3,3,9,1,1
22319,1,62,591.76,1,2,2,5,0,0
22320,1,77,1200.8200000000002,1,3,3,7,0,0
22321,1,133,882.18,1,3,3,7,0,0
22322,28,140,758.01,3,3,3,9,1,1
22323,331,1,1.95,4,1,1,6,0,0
22324,1,74,688.3,1,3,2,6,0,0
22325,10,99,1215.65,3,3,3,9,1,1
22326,1,749,24559.57,1,4,4,9,1,1
22327,1,293,4380.95,1,4,4,9,1,1
22328,1,597,20821.87,1,4,4,9,1,1
22329,1,241,2691.5899999999997,1,4,4,9,1,1
22331,1,185,2978.4399999999996,1,4,4,9,1,1
22332,5,152,1719.2499999999998,3,3,3,9,1,1
22333,3,329,7182.539999999999,2,4,4,10,1,1
22334,3,101,1160.7099999999998,2,3,3,8,0,0
22335,2,225,1672.7900000000002,2,4,3,9,1,1
22336,56,80,769.36,4,3,3,10,1,1
22337,7,77,574.5400000000001,3,3,2,8,0,0
22338,1,182,1246.94,1,4,3,8,0,0
22339,16,85,700.24,3,3,3,9,1,1
22340,1,129,809.68,1,3,3,7,0,0
22341,2,78,827.6299999999999,2,3,3,8,0,0
22342,1,130,1151.78,1,3,3,7,0,0
22343,1,95,889.1999999999999,1,3,3,7,0,0
22344,1,76,460.38,1,3,2,6,0,0
22345,1,72,414.91999999999996,1,3,2,6,0,0
22346,1,59,381.65999999999997,1,2,2,5,0,0
22348,1,359,3595.1899999999996,1,4,4,9,1,1
22349,4,133,5437.7699999999995,3,3,4,10,1,1
22350,1,121,3824.6699999999996,1,3,4,8,0,0
22351,163,2,23.089999999999996,4,1,1,6,0,0
22352,1,491,7914.5199999999995,1,4,4,9,1,1
22353,215,24,155.54999999999998,4,2,2,8,0,0
22354,3,84,2864.37,2,3,4,9,1,1
22355,1,894,29391.54,1,4,4,9,1,1
22356,1,759,11621.82,1,4,4,9,1,1
22357,1,188,2251.54,1,4,3,8,0,0
22358,1,259,2580.7200000000003,1,4,4,9,1,1
22359,3,83,617.57,2,3,2,7,0,0
22360,2,230,3495.4700000000003,2,4,4,10,1,1
22361,1,274,2633.23,1,4,4,9,1,1
22362,1,140,1426.7900000000002,1,3,3,7,0,0
22363,2,85,1719.25,2,3,3,8,0,0
22364,1,178,2192.62,1,4,3,8,0,0
22365,1,180,5778.18,1,4,4,9,1,1
22366,1,223,6228.97,1,4,4,9,1,1
22367,1,561,7590.48,1,4,4,9,1,1
22371,1,402,5151.35,1,4,4,9,1,1
22372,1,148,1293.74,1,3,3,7,0,0
22374,1,226,2457.27,1,4,4,9,1,1
22375,1,167,1639.29,1,3,3,7,0,0
22376,2,122,1141.7,2,3,3,8,0,0
22377,2,209,2189.98,2,4,3,9,1,1
22378,1,294,3651.17,1,4,4,9,1,1
22379,1,753,15759.64,1,4,4,9,1,1
22380,1,291,2901.56,1,4,4,9,1,1
22381,1,476,7494.39,1,4,4,9,1,1
22382,1,1170,18334.71,1,4,4,9,1,1
22383,1,1305,22766.239999999998,1,4,4,9,1,1
22384,1,1110,17671.39,1,4,4,9,1,1
22385,1,690,17297.0,1,4,4,9,1,1
22386,1,1231,43252.82,1,4,4,9,1,1
22389,1,46,851.55,1,2,3,6,0,0
22390,1,36,445.44,1,2,2,5,0,0
22391,1,29,245.57999999999998,1,2,2,5,0,0
22393,1,73,752.18,1,3,3,7,0,0
22394,1,24,245.98,1,2,2,5,0,0
22395,1,33,220.04,1,2,2,5,0,0
22396,1,130,649.43,1,3,2,6,0,0
22398,1,252,1694.51,1,4,3,8,0,0
22399,8,101,1377.08,3,3,3,9,1,1
22400,2,151,732.21,2,3,3,8,0,0
22402,1,153,1050.58,1,3,3,7,0,0
22403,3,127,704.67,2,3,3,8,0,0
22405,1,71,418.92,1,3,2,6,0,0
22406,1,85,404.71,1,3,2,6,0,0
22407,3,24,100.53,2,2,1,5,0,0
22408,4,29,163.69,3,2,2,7,0,0
22409,3,58,300.97,2,2,2,6,0,0
22410,1,58,247.42000000000002,1,2,2,5,0,0
22411,1,1187,29257.420000000002,1,4,4,9,1,1
22412,29,148,1942.3500000000001,3,3,3,9,1,1
22413,1,415,11157.890000000001,1,4,4,9,1,1
22414,2,97,2054.59,2,3,3,8,0,0
22415,318,13,151.05,4,1,2,7,0,0
22416,6,77,1219.52,3,3,3,9,1,1
22417,2,522,4591.84,2,4,4,10,1,1
22418,1,326,5731.65,1,4,4,9,1,1
22419,1,273,1679.3999999999999,1,4,3,8,0,0
22420,1,126,611.72,1,3,2,6,0,0
22421,1,214,1348.36,1,4,3,8,0,0
22422,1,205,776.75,1,4,3,8,0,0
22423,1,2168,184207.29,1,4,4,9,1,1
22424,1,471,12726.43,1,4,4,9,1,1
22425,2,169,2375.82,2,4,4,10,1,1
22426,2,212,2903.96,2,4,4,10,1,1
22427,11,519,12914.960000000001,3,4,4,11,1,1
22428,2,116,1875.6100000000001,2,3,3,8,0,0
22429,1,392,5689.93,1,4,4,9,1,1
22430,2,202,3365.09,2,4,4,10,1,1
22431,1,337,4018.2099999999996,1,4,4,9,1,1
22432,1,280,3377.9199999999996,1,4,4,9,1,1
22433,1,230,2673.35,1,4,4,9,1,1
22434,1,126,1615.26,1,3,3,7,0,0
22435,2,267,3471.75,2,4,4,10,1,1
22436,3,164,1425.16,2,3,3,8,0,0
22437,1,227,2427.44,1,4,4,9,1,1
22438,1,98,1058.69,1,3,3,7,0,0
22439,1,200,1341.3200000000002,1,4,3,8,0,0
22440,4,155,2389.32,3,3,4,10,1,1
22441,1,222,2307.61,1,4,4,9,1,1
22442,1,85,1328.75,1,3,3,7,0,0
22443,126,92,1415.5900000000001,4,3,3,10,1,1
22444,141,60,1147.87,4,2,3,9,1,1
22445,1,130,1624.7600000000002,1,3,3,7,0,0
22446,1,133,1135.18,1,3,3,7,0,0
22447,1,45,410.81,1,2,2,5,0,0
22448,3,45,656.4300000000001,2,2,2,6,0,0
22449,16,144,1607.4,3,3,3,9,1,1
22450,11,59,664.46,3,2,2,7,0,0
22451,211,51,779.1500000000001,4,2,3,9,1,1
22452,3,145,1834.0600000000002,2,3,3,8,0,0
22453,1,79,1194.64,1,3,3,7,0,0
22454,24,42,851.4200000000001,3,2,3,8,0,0
22456,1,508,9881.27,1,4,4,9,1,1
22457,1,1266,28300.56,1,4,4,9,1,1
22458,234,23,1421.83,4,2,3,9,1,1
22459,227,25,1018.19,4,2,3,9,1,1
22460,1,217,3313.5,1,4,4,9,1,1
22461,87,66,1627.03,4,3,3,10,1,1
22464,1,362,5706.32,1,4,4,9,1,1
22465,1,205,3195.24,1,4,4,9,1,1
22466,1,212,5643.59,1,4,4,9,1,1
22467,1,711,19227.97,1,4,4,9,1,1
22468,2,155,3652.62,2,3,4,9,1,1
22469,1,1212,32315.75,1,4,4,9,1,1
22470,1,941,30328.91,1,4,4,9,1,1
22471,1,106,1508.92,1,3,3,7,0,0
22472,1,109,1546.81,1,3,3,7,0,0
22473,1,112,1623.04,1,3,3,7,0,0
22474,1,133,1772.27,1,3,3,7,0,0
22475,1,138,1605.67,1,3,3,7,0,0
22476,1,126,2883.7599999999998,1,3,4,8,0,0
22477,1,128,1981.65,1,3,3,7,0,0
22478,1,140,2218.12,1,3,3,7,0,0
22479,1,98,1658.57,1,3,3,7,0,0
22480,103,73,757.21,4,3,3,10,1,1
22481,1,128,748.08,1,3,3,7,0,0
22482,157,53,565.86,4,2,2,8,0,0
22483,1,170,2317.69,1,4,4,9,1,1
22485,1,212,7266.849999999999,1,4,4,9,1,1
22486,1,28,522.95,1,2,2,5,0,0
22487,2,446,8152.03,2,4,4,10,1,1
22488,1,424,5633.079999999999,1,4,4,9,1,1
22489,1,445,4073.81,1,4,4,9,1,1
22491,1,220,3204.0299999999997,1,4,4,9,1,1
22492,1,390,17065.22,1,4,4,9,1,1
22493,1,224,4386.389999999999,1,4,4,9,1,1
22494,2,252,1623.52,2,4,3,9,1,1
22495,1,99,769.47,1,3,3,7,0,0
22496,1,80,549.86,1,3,2,6,0,0
22497,4,100,1145.15,3,3,3,9,1,1
22498,1,150,2121.9900000000002,1,3,3,7,0,0
22499,3,409,12816.050000000001,2,4,4,10,1,1
22500,1,96,980.7,1,3,3,7,0,0
22501,33,462,20195.36,4,4,4,12,1,1
22502,75,472,51811.87,4,4,4,12,1,1
22503,13,37,2471.97,3,2,4,9,1,1
22504,4,72,4807.17,3,3,4,10,1,1
22505,1,316,7128.97,1,4,4,9,1,1
22507,1,464,14227.3,1,4,4,9,1,1
22508,1,300,6627.13,1,4,4,9,1,1
22509,1,88,2371.64,1,3,4,8,0,0
22510,1,42,406.49,1,2,2,5,0,0
22511,1,55,498.95,1,2,2,5,0,0
22512,3,37,273.46,2,2,2,6,0,0
22513,1,67,543.65,1,3,2,6,0,0
22514,1,99,706.5500000000001,1,3,3,7,0,0
22515,3,85,613.1500000000001,2,3,2,7,0,0
22516,1,62,496.99,1,2,2,5,0,0
22517,3,69,462.33000000000004,2,3,2,7,0,0
22518,207,81,783.5400000000001,4,3,3,10,1,1
22519,186,88,906.7500000000001,4,3,3,10,1,1
22520,207,113,622.0999999999999,4,3,2,9,1,1
22521,218,104,533.16,4,3,2,9,1,1
22522,1,129,784.49,1,3,3,7,0,0
22523,2,136,761.8599999999999,2,3,3,8,0,0
22524,200,81,883.1999999999999,4,3,3,10,1,1
22525,235,74,648.97,4,3,2,9,1,1
22526,1,83,1796.76,1,3,3,7,0,0
22528,367,1,3.36,4,1,1,6,0,0
22529,1,70,349.87,1,3,2,6,0,0
22530,1,234,1527.8,1,4,3,8,0,0
22531,1,200,1413.25,1,4,3,8,0,0
22532,1,73,366.75,1,3,2,6,0,0
22533,1,89,656.5699999999999,1,3,2,6,0,0
22534,1,262,1871.96,1,4,3,8,0,0
22535,7,135,691.17,3,3,2,8,0,0
22536,1,158,1853.03,1,3,3,7,0,0
22537,5,172,865.0,3,4,3,10,1,1
22538,5,40,164.84,3,2,2,7,0,0
22539,1,136,1130.58,1,3,3,7,0,0
22540,1,92,961.28,1,3,3,7,0,0
22541,3,35,202.37,2,2,2,6,0,0
22543,1,55,531.64,1,2,2,5,0,0
22544,1,176,1734.24,1,4,3,8,0,0
22545,1,76,436.51,1,3,2,6,0,0
22546,1,87,800.8199999999999,1,3,3,7,0,0
22547,1,102,339.07,1,3,2,6,0,0
22548,26,209,2351.44,3,4,4,11,1,1
22549,1,356,4799.83,1,4,4,9,1,1
22550,1,219,4224.89,1,4,4,9,1,1
22551,1,681,13663.159999999998,1,4,4,9,1,1
22553,1,567,7315.2699999999995,1,4,4,9,1,1
22554,1,709,13392.619999999999,1,4,4,9,1,1
22555,1,519,9897.929999999998,1,4,4,9,1,1
22556,1,581,10179.009999999998,1,4,4,9,1,1
22557,1,570,7821.639999999999,1,4,4,9,1,1
22558,1,783,13412.619999999999,1,4,4,9,1,1
22559,4,81,626.53,3,3,2,8,0,0
22560,1,390,9603.380000000001,1,4,4,9,1,1
22561,1,436,10154.82,1,4,4,9,1,1
22562,1,211,1773.3700000000001,1,4,3,8,0,0
22563,1,282,3359.4300000000003,1,4,4,9,1,1
22564,1,188,3527.69,1,4,4,9,1,1
22565,1,148,873.52,1,3,3,7,0,0
22566,1,150,794.88,1,3,3,7,0,0
22567,1,227,3315.0,1,4,4,9,1,1
22568,2,477,13468.960000000001,2,4,4,10,1,1
22569,46,351,10791.71,4,4,4,12,1,1
22570,21,389,12059.82,3,4,4,11,1,1
22571,1,257,2271.6,1,4,3,8,0,0
22572,10,179,1255.72,3,4,3,10,1,1
22573,1,221,2427.25,1,4,4,9,1,1
22574,1,223,2340.3799999999997,1,4,4,9,1,1
22575,4,91,1233.77,3,3,3,9,1,1
22576,1,174,1420.4099999999999,1,4,3,8,0,0
22577,1,540,4158.99,1,4,4,9,1,1
22578,1,515,3990.1699999999996,1,4,4,9,1,1
22579,11,339,2070.49,3,4,3,10,1,1
22580,1,250,7175.04,1,4,4,9,1,1
22581,1,178,1140.6799999999998,1,4,3,8,0,0
22582,2,103,2679.95,2,3,4,9,1,1
22583,1,113,1578.05,1,3,3,7,0,0
22584,1,198,5992.86,1,4,4,9,1,1
22585,1,398,7617.89,1,4,4,9,1,1
22586,1,163,815.3499999999999,1,3,3,7,0,0
22587,1,161,833.0699999999999,1,3,3,7,0,0
22588,1,178,2561.18,1,4,4,9,1,1
22589,1,79,1212.82,1,3,3,7,0,0
22591,1,92,1665.46,1,3,3,7,0,0
22592,1,137,3028.62,1,3,4,8,0,0
22593,1,199,2191.02,1,4,3,8,0,0
22594,1,197,1906.62,1,4,3,8,0,0
22595,1,468,5834.94,1,4,4,9,1,1
22596,1,268,4173.64,1,4,4,9,1,1
22597,1,188,1276.6799999999998,1,4,3,8,0,0
22598,1,96,452.46,1,3,2,6,0,0
22599,1,124,988.16,1,3,3,7,0,0
22600,1,196,1568.7299999999998,1,4,3,8,0,0
22601,1,203,2225.7799999999997,1,4,3,8,0,0
22602,1,275,2059.5699999999997,1,4,3,8,0,0
22603,1,173,1248.1299999999999,1,4,3,8,0,0
22604,2,125,3044.76,2,3,4,9,1,1
22605,1,306,11373.21,1,4,4,9,1,1
22606,1,150,4788.61,1,3,4,8,0,0
22607,1,362,12608.269999999999,1,4,4,9,1,1
22608,1,145,1122.81,1,3,3,7,0,0
22609,2,156,1388.62,2,3,3,8,0,0
22610,2,216,2578.24,2,4,4,10,1,1
22611,15,46,1077.03,3,2,3,8,0,0
22613,1,146,1231.11,1,3,3,7,0,0
22614,1,223,1039.33,1,4,3,8,0,0
22615,1,103,665.41,1,3,2,6,0,0
22616,1,514,7989.08,1,4,4,9,1,1
22617,1,479,10887.2,1,4,4,9,1,1
22618,217,31,845.71,4,2,3,9,1,1
22619,1,444,9936.29,1,4,4,9,1,1
22620,1,485,6802.36,1,4,4,9,1,1
22621,1,613,10121.699999999999,1,4,4,9,1,1
22622,1,272,14082.66,1,4,4,9,1,1
22623,2,240,5333.410000000001,2,4,4,10,1,1
22624,1,720,16696.61,1,4,4,9,1,1
22625,1,564,14339.75,1,4,4,9,1,1
22626,1,203,4503.86,1,4,4,9,1,1
22627,1,370,7664.6,1,4,4,9,1,1
22628,1,201,4729.81,1,4,4,9,1,1
22629,1,908,25833.17,1,4,4,9,1,1
22630,1,860,22113.789999999997,1,4,4,9,1,1
22631,1,401,7271.719999999999,1,4,4,9,1,1
22632,1,400,9054.580000000002,1,4,4,9,1,1
22633,1,486,10111.92,1,4,4,9,1,1
22634,1,245,7573.0,1,4,4,9,1,1
22635,2,201,7149.33,2,4,4,10,1,1
22636,1,212,5249.26,1,4,4,9,1,1
22637,13,352,7257.58,3,4,4,11,1,1
22638,1,53,484.43,1,2,2,5,0,0
22639,2,148,1937.7099999999998,2,3,3,8,0,0
22640,2,57,449.39,2,2,2,6,0,0
22641,2,37,303.72999999999996,2,2,2,6,0,0
22642,1,51,596.36,1,2,2,5,0,0
22643,1,48,445.16999999999996,1,2,2,5,0,0
22644,1,280,3013.0699999999997,1,4,4,9,1,1
22645,1,355,4746.18,1,4,4,9,1,1
22646,1,399,5737.67,1,4,4,9,1,1
22647,1,46,483.58,1,2,2,5,0,0
22649,5,220,4342.93,3,4,4,11,1,1
22650,1,145,1338.1,1,3,3,7,0,0
22651,1,170,1837.4699999999998,1,4,3,8,0,0
22652,16,472,8645.07,3,4,4,11,1,1
22653,1,252,3438.95,1,4,4,9,1,1
22654,1,342,10092.300000000001,1,4,4,9,1,1
22655,38,46,9855.5,4,2,4,10,1,1
22656,58,26,4485.0,4,2,4,10,1,1
22659,1,725,21364.7,1,4,4,9,1,1
22660,3,102,2678.96,2,3,4,9,1,1
22661,1,419,4242.74,1,4,4,9,1,1
22662,1,690,11118.63,1,4,4,9,1,1
22663,1,452,7074.7300000000005,1,4,4,9,1,1
22664,1,165,1498.05,1,3,3,7,0,0
22665,15,365,5257.13,3,4,4,11,1,1
22666,1,1158,26661.65,1,4,4,9,1,1
22667,1,485,8361.9,1,4,4,9,1,1
22668,2,348,6867.42,2,4,4,10,1,1
22669,2,235,3686.5,2,4,4,10,1,1
22670,1,303,2524.25,1,4,4,9,1,1
22671,1,145,1611.7999999999997,1,3,3,7,0,0
22672,1,222,2537.62,1,4,4,9,1,1
22673,2,132,1034.83,2,3,3,8,0,0
22674,1,189,1713.97,1,4,3,8,0,0
22675,1,167,1592.66,1,3,3,7,0,0
22676,1,201,1594.64,1,4,3,8,0,0
22677,7,190,1402.82,3,4,3,10,1,1
22678,1,162,1166.56,1,3,3,7,0,0
22679,1,153,1036.78,1,3,3,7,0,0
22680,2,155,1197.79,2,3,3,8,0,0
22681,4,129,987.96,3,3,3,9,1,1
22682,3,115,910.5,2,3,3,8,0,0
22683,8,121,886.49,3,3,3,9,1,1
22684,1,101,744.82,1,3,3,7,0,0
22685,1,100,793.3,1,3,3,7,0,0
22686,1,160,1338.38,1,3,3,7,0,0
22687,2,52,3354.22,2,2,4,8,0,0
22688,1,32,3519.6600000000003,1,2,4,7,0,0
22689,11,148,5530.25,3,3,4,10,1,1
22690,1,289,10007.9,1,4,4,9,1,1
22691,1,122,2710.87,1,3,4,8,0,0
22692,1,445,11579.41,1,4,4,9,1,1
22693,1,307,18017.45,1,4,4,9,1,1
22694,1,409,4369.320000000001,1,4,4,9,1,1
22695,1,123,1001.49,1,3,3,7,0,0
22696,3,151,1456.4499999999998,2,3,3,8,0,0
22697,1,1055,23219.350000000002,1,4,4,9,1,1
22698,1,800,17939.260000000002,1,4,4,9,1,1
22699,1,1119,30245.62,1,4,4,9,1,1
22700,63,56,2639.38,4,2,4,10,1,1
22701,1,120,965.89,1,3,3,7,0,0
22702,7,49,2684.6499999999996,3,2,4,9,1,1
22703,1,123,583.33,1,3,2,6,0,0
22704,1,176,2189.76,1,4,3,8,0,0
22705,4,78,811.86,3,3,3,9,1,1
22706,3,72,858.44,2,3,3,8,0,0
22707,8,49,527.94,3,2,2,7,0,0
22708,2,101,1170.5,2,3,3,8,0,0
22709,2,39,528.5,2,2,2,6,0,0
22710,4,106,1795.42,3,3,3,9,1,1
22711,1,105,1234.34,1,3,3,7,0,0
22712,1,315,1852.86,1,4,3,8,0,0
22713,1,218,1465.92,1,4,3,8,0,0
22714,1,226,1420.77,1,4,3,8,0,0
22715,12,130,645.64,3,3,2,8,0,0
22716,1,288,1365.95,1,4,3,8,0,0
22717,1,131,535.78,1,3,2,6,0,0
22718,2,170,737.39,2,4,3,9,1,1
22719,213,113,906.89,4,3,3,10,1,1
22720,1,1458,38903.340000000004,1,4,4,9,1,1
22721,1,297,4678.71,1,4,4,9,1,1
22722,1,846,24601.66,1,4,4,9,1,1
22723,1,297,4290.47,1,4,4,9,1,1
22725,1,441,8356.1,1,4,4,9,1,1
22726,1,1001,27354.03,1,4,4,9,1,1
22727,1,1081,30978.62,1,4,4,9,1,1
22728,1,799,20855.9,1,4,4,9,1,1
22729,5,462,9196.09,3,4,4,11,1,1
22730,1,583,11674.65,1,4,4,9,1,1
22731,3,144,1553.74,2,3,3,8,0,0
22732,2,188,2162.75,2,4,3,9,1,1
22733,1,197,2095.08,1,4,3,8,0,0
22734,1,426,10708.300000000001,1,4,4,9,1,1
22735,1,136,1387.46,1,3,3,7,0,0
22736,1,225,2336.7,1,4,4,9,1,1
22737,2,261,2761.8,2,4,4,10,1,1
22738,1,277,4046.57,1,4,4,9,1,1
22739,1,319,3601.52,1,4,4,9,1,1
22740,74,170,5793.62,4,4,4,12,1,1
22741,1,236,7407.209999999999,1,4,4,9,1,1
22742,1,102,1339.1100000000001,1,3,3,7,0,0
22743,1,207,2438.0400000000004,1,4,4,9,1,1
22744,1,174,2115.1400000000003,1,4,3,8,0,0
22745,1,426,4705.89,1,4,4,9,1,1
22746,1,330,3270.1400000000003,1,4,4,9,1,1
22747,1,228,2099.75,1,4,3,8,0,0
22748,1,440,4933.33,1,4,4,9,1,1
22749,1,449,9264.91,1,4,4,9,1,1
22750,1,415,7585.58,1,4,4,9,1,1
22751,1,291,5820.22,1,4,4,9,1,1
22752,1,385,15405.470000000001,1,4,4,9,1,1
22753,1,217,758.98,1,4,3,8,0,0
22754,1,266,1352.1699999999998,1,4,3,8,0,0
22755,1,251,1190.51,1,4,3,8,0,0
22756,1,123,656.52,1,3,2,6,0,0
22757,1,164,1170.24,1,3,3,7,0,0
22758,1,178,1112.75,1,4,3,8,0,0
22759,10,424,9083.539999999999,3,4,4,11,1,1
22760,96,86,3566.56,4,3,4,11,1,1
22761,7,27,939.28,3,2,3,8,0,0
22762,3,119,3030.93,2,3,4,9,1,1
22763,1,111,2236.02,1,3,3,7,0,0
22764,260,4,199.72,4,1,2,7,0,0
22765,365,5,316.95000000000005,4,1,2,7,0,0
22766,1,520,9999.94,1,4,4,9,1,1
22767,1,235,7521.799999999999,1,4,4,9,1,1
22768,1,285,8623.84,1,4,4,9,1,1
22769,339,10,592.23,4,1,2,7,0,0
22770,5,66,1575.48,3,3,3,9,1,1
22771,2,445,9087.94,2,4,4,10,1,1
22772,2,256,5215.45,2,4,4,10,1,1
22773,3,191,2754.4,2,4,4,10,1,1
22774,3,143,2921.56,2,3,4,9,1,1
22775,1,239,4656.87,1,4,4,9,1,1
22776,1,576,13951.73,1,4,4,9,1,1
22777,141,62,2993.1800000000003,4,2,4,10,1,1
22778,16,161,3369.94,3,3,4,10,1,1
22779,1,155,5908.85,1,3,4,8,0,0
22780,1,140,5150.59,1,3,4,8,0,0
22781,1,245,5551.01,1,4,4,9,1,1
22782,3,74,3399.95,2,3,4,9,1,1
22783,179,33,5961.25,4,2,4,10,1,1
22784,1,326,6606.39,1,4,4,9,1,1
22785,1,74,1087.57,1,3,3,7,0,0
22786,2,47,764.63,2,2,3,7,0,0
22788,177,64,2082.76,4,2,3,9,1,1
22789,1,139,1690.17,1,3,3,7,0,0
22791,1,355,10156.630000000001,1,4,4,9,1,1
22792,1,207,2653.5299999999997,1,4,4,9,1,1
22794,1,186,2824.65,1,4,4,9,1,1
22795,1,371,8656.45,1,4,4,9,1,1
22796,1,254,6331.4,1,4,4,9,1,1
22797,3,101,3088.66,2,3,4,9,1,1
22798,1,284,5697.0,1,4,4,9,1,1
22799,4,89,1631.58,3,3,3,9,1,1
22800,1,209,3601.99,1,4,4,9,1,1
22801,1,231,4286.03,1,4,4,9,1,1
22802,3,49,1494.69,2,2,3,7,0,0
22803,26,31,2038.0900000000001,3,2,3,8,0,0
22804,2,482,8590.6,2,4,4,10,1,1
22805,1,197,2609.78,1,4,4,9,1,1
22806,2,38,677.0400000000001,2,2,2,6,0,0
22807,1,195,2428.1800000000003,1,4,4,9,1,1
22808,1,76,1091.97,1,3,3,7,0,0
22809,1,207,3906.2000000000003,1,4,4,9,1,1
22810,4,167,3185.78,3,3,4,10,1,1
22811,1,109,2422.24,1,3,4,8,0,0
22812,4,188,3651.2,3,4,4,11,1,1
22813,1,218,4640.78,1,4,4,9,1,1
22814,1,235,893.51,1,4,3,8,0,0
22815,1,268,1123.8799999999999,1,4,3,8,0,0
22816,1,266,1706.8799999999999,1,4,3,8,0,0
22817,1,290,1114.81,1,4,3,8,0,0
22818,1,247,1600.8,1,4,3,8,0,0
22819,1,270,1104.81,1,4,3,8,0,0
22820,7,78,576.72,3,3,2,8,0,0
22821,1,140,738.2700000000001,1,3,3,7,0,0
22822,1,160,2600.6,1,3,4,8,0,0
22823,25,13,2745.0,3,1,4,8,0,0
22824,17,44,1974.2000000000003,3,2,3,8,0,0
22825,12,29,597.87,3,2,2,7,0,0
22826,8,45,6727.5,3,2,4,9,1,1
22827,22,29,5830.0,3,2,4,9,1,1
22828,24,7,1530.0,3,1,3,7,0,0
22829,28,111,2403.23,3,3,4,10,1,1
22830,327,6,2610.29,4,1,4,9,1,1
22831,8,121,2070.9,3,3,3,9,1,1
22832,10,81,1857.07,3,3,3,9,1,1
22833,310,5,2603.5299999999997,4,1,4,9,1,1
22834,1,375,7442.28,1,4,4,9,1,1
22835,1,663,19734.81,1,4,4,9,1,1
22837,75,180,5820.2300000000005,4,4,4,12,1,1
22838,1,182,11436.71,1,4,4,9,1,1
22839,2,211,7220.87,2,4,4,10,1,1
22840,1,286,7085.64,1,4,4,9,1,1
22841,2,222,4213.07,2,4,4,10,1,1
22842,4,176,3950.6600000000003,3,4,4,11,1,1
22843,5,134,2978.77,3,3,4,10,1,1
22844,1,424,9914.62,1,4,4,9,1,1
22845,1,325,5491.38,1,4,4,9,1,1
22846,2,296,11093.32,2,4,4,10,1,1
22847,1,407,15101.14,1,4,4,9,1,1
22848,40,136,5401.849999999999,4,3,4,11,1,1
22849,51,137,5295.88,4,3,4,11,1,1
22851,2,352,2386.49,2,4,4,10,1,1
22852,1,127,1779.1299999999999,1,3,3,7,0,0
22853,1,117,1675.46,1,3,3,7,0,0
22854,79,164,3723.37,4,3,4,11,1,1
22855,101,238,3319.23,4,4,4,12,1,1
22856,20,29,755.82,3,2,3,8,0,0
22857,46,61,977.7599999999999,4,2,3,9,1,1
22858,64,139,1882.2299999999998,4,3,3,10,1,1
22859,24,164,2065.77,3,3,3,9,1,1
22860,21,109,1057.37,3,3,3,9,1,1
22861,232,50,522.93,4,2,2,8,0,0
22862,318,66,843.95,4,3,3,10,1,1
22863,4,112,2114.98,3,3,3,9,1,1
22865,1,665,18168.08,1,4,4,9,1,1
22866,1,553,14619.720000000001,1,4,4,9,1,1
22867,1,560,14189.990000000002,1,4,4,9,1,1
22868,18,20,146.6,3,2,2,7,0,0
22869,10,45,248.09,3,2,2,7,0,0
22870,10,39,242.24,3,2,2,7,0,0
22871,23,25,163.35,3,2,2,7,0,0
22872,2,30,177.46,2,2,2,6,0,0
22873,14,26,145.5,3,2,2,7,0,0
22874,30,21,150.81,3,2,2,7,0,0
22875,2,25,149.09,2,2,2,6,0,0
22876,73,20,138.81,4,2,2,8,0,0
22877,66,20,140.06,4,2,2,8,0,0
22878,23,34,206.29,3,2,2,7,0,0
22879,66,16,102.46,4,1,1,6,0,0
22880,25,32,200.59,3,2,2,7,0,0
22881,1,34,197.56,1,2,2,5,0,0
22882,4,43,215.65,3,2,2,7,0,0
22883,4,33,193.43,3,2,2,7,0,0
22884,10,36,194.04999999999998,3,2,2,7,0,0
22885,1,29,174.73,1,2,2,5,0,0
22886,8,25,146.43,3,2,2,7,0,0
22887,4,23,126.78,3,2,1,6,0,0
22888,1,21,124.97999999999999,1,2,1,4,0,0
22889,5,33,272.2,3,2,2,7,0,0
22890,1,177,4267.82,1,4,4,9,1,1
22891,1,186,2252.68,1,4,3,8,0,0
22892,18,216,3144.29,3,4,4,11,1,1
22893,2,147,939.8399999999999,2,3,3,8,0,0
22894,1,122,3027.3799999999997,1,3,4,8,0,0
22895,1,285,6367.65,1,4,4,9,1,1
22896,1,290,4109.66,1,4,4,9,1,1
22897,1,216,2076.9,1,4,3,8,0,0
22898,1,365,5174.32,1,4,4,9,1,1
22899,1,316,4339.030000000001,1,4,4,9,1,1
22900,1,544,15528.53,1,4,4,9,1,1
22902,1,138,2700.48,1,3,4,8,0,0
22903,1,59,550.6,1,2,2,5,0,0
22904,23,272,5484.960000000001,3,4,4,11,1,1
22905,1,110,1505.24,1,3,3,7,0,0
22906,1,252,2961.0699999999997,1,4,4,9,1,1
22907,1,676,5726.099999999999,1,4,4,9,1,1
22908,1,377,3576.38,1,4,4,9,1,1
22909,1,617,8245.72,1,4,4,9,1,1
22910,1,832,33804.79,1,4,4,9,1,1
22911,5,97,1378.74,3,3,3,9,1,1
22912,11,102,1372.0900000000001,3,3,3,9,1,1
22913,4,114,1692.95,3,3,3,9,1,1
22914,1,158,2290.9100000000003,1,3,3,7,0,0
22915,1,188,1444.22,1,4,3,8,0,0
22916,1,238,1323.96,1,4,3,8,0,0
22917,1,241,1352.5700000000002,1,4,3,8,0,0
22918,1,239,1286.4,1,4,3,8,0,0
22919,1,241,1232.26,1,4,3,8,0,0
22920,1,244,2996.9900000000002,1,4,4,9,1,1
22921,1,210,1191.92,1,4,3,8,0,0
22922,1,107,1606.1999999999998,1,3,3,7,0,0
22923,1,86,1274.9699999999998,1,3,3,7,0,0
22924,1,92,1410.1499999999999,1,3,3,7,0,0
22925,43,187,2811.02,4,4,4,12,1,1
22926,214,201,3763.9500000000003,4,4,4,12,1,1
22927,5,155,2788.01,3,3,4,10,1,1
22928,1,119,2029.45,1,3,3,7,0,0
22929,44,15,1394.75,4,1,3,8,0,0
22930,1,190,3050.95,1,4,4,9,1,1
22931,1,129,1968.4,1,3,3,7,0,0
22932,1,74,2263.6800000000003,1,3,3,7,0,0
22933,4,124,2923.7200000000003,3,3,4,10,1,1
22934,28,79,1716.3200000000002,3,3,3,9,1,1
22935,1,66,2264.82,1,3,3,7,0,0
22936,1,51,1093.97,1,2,3,6,0,0
22937,3,162,2601.49,2,3,4,9,1,1
22938,1,190,4605.63,1,4,4,9,1,1
22939,4,127,2476.82,3,3,4,10,1,1
22940,1,326,8053.5,1,4,4,9,1,1
22941,1,331,14242.17,1,4,4,9,1,1
22942,1,164,5073.39,1,3,4,8,0,0
22943,1,220,6950.67,1,4,4,9,1,1
22944,2,113,1849.5700000000002,2,3,3,8,0,0
22945,2,177,3219.7,2,4,4,10,1,1
22946,1,144,7284.92,1,3,4,8,0,0
22947,9,141,8787.16,3,3,4,10,1,1
22948,1,138,1615.1899999999998,1,3,3,7,0,0
22949,3,107,1455.25,2,3,3,8,0,0
22950,33,189,7546.65,4,4,4,12,1,1
22951,1,442,4076.55,1,4,4,9,1,1
22952,1,623,9665.12,1,4,4,9,1,1
22953,2,98,647.11,2,3,2,7,0,0
22954,15,41,248.88,3,2,2,7,0,0
22955,1,134,2070.15,1,3,3,7,0,0
22956,1,201,4275.780000000001,1,4,4,9,1,1
22957,71,218,5095.400000000001,4,4,4,12,1,1
22959,2,145,2140.42,2,3,3,8,0,0
22960,1,1219,38141.67,1,4,4,9,1,1
22961,1,1174,26086.73,1,4,4,9,1,1
22962,1,363,3367.88,1,4,4,9,1,1
22963,1,319,2869.7,1,4,4,9,1,1
22964,1,385,5510.490000000001,1,4,4,9,1,1
22965,1,241,2994.61,1,4,4,9,1,1
22966,1,672,9218.4,1,4,4,9,1,1
22967,2,142,3342.21,2,3,4,9,1,1
22968,1,199,8050.78,1,4,4,9,1,1
22969,1,654,18974.35,1,4,4,9,1,1
22970,1,320,10258.35,1,4,4,9,1,1
22971,2,277,5886.94,2,4,4,10,1,1
22972,1,237,3128.6899999999996,1,4,4,9,1,1
22973,2,149,2182.2099999999996,2,3,3,8,0,0
22974,2,211,2777.5399999999995,2,4,4,10,1,1
22975,1,187,1625.88,1,4,3,8,0,0
22976,1,145,1466.51,1,3,3,7,0,0
22977,1,136,1255.11,1,3,3,7,0,0
22978,1,250,9841.34,1,4,4,9,1,1
22979,1,386,6519.5199999999995,1,4,4,9,1,1
22980,1,297,4039.0099999999998,1,4,4,9,1,1
22981,2,107,714.28,2,3,3,8,0,0
22982,1,214,1575.02,1,4,3,8,0,0
22983,1,446,2330.36,1,4,4,9,1,1
22984,1,163,1106.17,1,3,3,7,0,0
22985,1,99,1500.44,1,3,3,7,0,0
22986,2,156,1722.6,2,3,3,8,0,0
22987,60,5,42.84,4,1,1,6,0,0
22988,1,426,11071.09,1,4,4,9,1,1
22989,1,376,9090.27,1,4,4,9,1,1
22990,1,175,3495.88,1,4,4,9,1,1
22991,1,280,8794.69,1,4,4,9,1,1
22992,1,356,11573.24,1,4,4,9,1,1
22993,1,1082,16592.23,1,4,4,9,1,1
22994,1,224,970.8,1,4,3,8,0,0
22995,1,269,1082.58,1,4,3,8,0,0
22996,1,412,2110.89,1,4,3,8,0,0
22997,1,230,1148.69,1,4,3,8,0,0
22998,1,545,5389.24,1,4,4,9,1,1
22999,1,224,1281.57,1,4,3,8,0,0
23000,1,282,1385.5,1,4,3,8,0,0
23002,1,200,979.05,1,4,3,8,0,0
23003,181,53,226.2,4,2,2,8,0,0
23004,1,225,984.22,1,4,3,8,0,0
23005,1,242,2147.97,1,4,3,8,0,0
23006,1,178,798.03,1,4,3,8,0,0
23007,1,187,7860.4,1,4,4,9,1,1
23008,1,137,6872.16,1,3,4,8,0,0
23009,1,103,4082.5199999999995,1,3,4,8,0,0
23010,6,113,4947.4,3,3,4,10,1,1
23012,1,251,4240.56,1,4,4,9,1,1
23013,1,226,3701.8100000000004,1,4,4,9,1,1
23014,1,212,3463.03,1,4,4,9,1,1
23015,15,21,404.38,3,2,2,7,0,0
23016,4,25,595.2,3,2,2,7,0,0
23017,2,23,838.78,2,2,3,7,0,0
23018,23,21,612.1600000000001,3,2,2,7,0,0
23019,2,28,629.0500000000001,2,2,2,6,0,0
23020,2,82,2265.4900000000002,2,3,3,8,0,0
23021,4,27,504.97,3,2,2,7,0,0
23022,4,24,870.5600000000001,3,2,3,8,0,0
23023,4,26,460.91999999999996,3,2,2,7,0,0
23024,25,12,672.83,3,1,2,6,0,0
23025,8,55,773.28,3,2,3,8,0,0
23026,3,64,1230.16,2,2,3,7,0,0
23027,8,30,627.95,3,2,2,7,0,0
23028,37,140,2398.58,4,3,4,11,1,1
23029,1,164,2350.12,1,3,4,8,0,0
23031,2,164,2214.9999999999995,2,3,3,8,0,0
23032,9,210,3952.68,3,4,4,11,1,1
23033,1,74,1067.6,1,3,3,7,0,0
23034,1,89,1474.77,1,3,3,7,0,0
23035,1,193,3239.14,1,4,4,9,1,1
23036,4,16,233.67000000000002,3,1,2,6,0,0
23037,1,20,325.15999999999997,1,2,2,5,0,0
23038,4,8,42.919999999999995,3,1,1,5,0,0
23039,5,29,411.40999999999997,3,2,2,7,0,0
23040,1,41,1394.03,1,2,3,6,0,0
23041,1,55,1278.0800000000002,1,2,3,6,0,0
23042,5,29,778.01,3,2,3,8,0,0
23043,4,23,543.51,3,2,2,7,0,0
23044,8,25,435.74000000000007,3,2,2,7,0,0
23045,3,26,580.98,2,2,2,6,0,0
23046,4,36,2111.4900000000002,3,2,3,8,0,0
23047,16,25,333.5,3,2,2,7,0,0
23048,1,104,2521.92,1,3,4,8,0,0
23049,8,188,3921.59,3,4,4,11,1,1
23050,1,206,4294.8,1,4,4,9,1,1
23051,1,164,3239.99,1,3,4,8,0,0
23052,1,279,5957.59,1,4,4,9,1,1
23053,1,165,3270.82,1,3,4,8,0,0
23054,1,131,2629.68,1,3,4,8,0,0
23055,18,43,2092.15,3,2,3,8,0,0
23056,16,46,4775.94,3,2,4,9,1,1
23057,18,51,2419.67,3,2,4,9,1,1
23058,3,48,430.86,2,2,2,6,0,0
23060,2,42,528.1700000000001,2,2,2,6,0,0
23061,2,118,1358.93,2,3,3,8,0,0
23064,19,33,5231.610000000001,3,2,4,9,1,1
23065,21,100,3452.44,3,3,4,10,1,1
23066,57,86,2146.06,4,3,3,10,1,1
23067,2,78,1249.1100000000001,2,3,3,8,0,0
23068,4,136,1976.89,3,3,3,9,1,1
23069,5,32,568.71,3,2,2,7,0,0
23070,3,44,709.5400000000001,2,2,3,7,0,0
23071,44,23,1689.1,4,2,3,9,1,1
23072,44,32,1657.76,4,2,3,9,1,1
23073,8,62,1731.5,3,2,3,8,0,0
23074,1,49,568.07,1,2,2,5,0,0
23075,2,86,2122.15,2,3,3,8,0,0
23076,1,279,10000.76,1,4,4,9,1,1
23077,1,347,13795.77,1,4,4,9,1,1
23078,3,259,8613.34,2,4,4,10,1,1
23079,2,113,2368.6499999999996,2,3,4,9,1,1
23080,1,264,9249.62,1,4,4,9,1,1
23081,1,142,4096.0,1,3,4,8,0,0
23082,1,303,8680.67,1,4,4,9,1,1
23083,1,249,7468.820000000001,1,4,4,9,1,1
23084,1,1009,67173.39,1,4,4,9,1,1
23085,1,83,3763.98,1,3,4,8,0,0
23086,2,48,1475.18,2,2,3,7,0,0
23087,2,70,1109.41,2,3,3,8,0,0
23088,1,79,1033.28,1,3,3,7,0,0
23089,1,232,4243.38,1,4,4,9,1,1
23090,2,150,1878.33,2,3,3,8,0,0
23091,29,213,3768.82,3,4,4,11,1,1
23092,1,144,3851.3300000000004,1,3,4,8,0,0
23093,1,144,2251.69,1,3,3,7,0,0
23094,11,81,1949.92,3,3,3,9,1,1
23096,1,146,1759.7899999999997,1,3,3,7,0,0
23099,2,62,978.5500000000001,2,2,3,7,0,0
23100,1,258,2744.38,1,4,4,9,1,1
23101,2,213,1744.61,2,4,3,9,1,1
23102,5,157,1086.6499999999999,3,3,3,9,1,1
23103,1,368,6905.5599999999995,1,4,4,9,1,1
23104,2,46,1405.42,2,2,3,7,0,0
23106,2,54,850.27,2,2,3,7,0,0
23107,1,73,1009.51,1,3,3,7,0,0
23108,1,390,13620.619999999999,1,4,4,9,1,1
23109,1,269,7117.41,1,4,4,9,1,1
23110,1,283,4451.93,1,4,4,9,1,1
23111,1,154,4122.4400000000005,1,3,4,8,0,0
23112,1,260,4754.43,1,4,4,9,1,1
23113,2,63,10671.56,2,2,4,8,0,0
23114,1,47,752.8000000000001,1,2,3,6,0,0
23115,2,45,785.1700000000001,2,2,3,7,0,0
23116,4,22,392.34000000000003,3,2,2,7,0,0
23117,3,46,506.18,2,2,2,6,0,0
23118,1,275,6282.18,1,4,4,9,1,1
23119,2,153,1424.64,2,3,3,8,0,0
23120,2,102,725.65,2,3,3,8,0,0
23121,4,111,1002.54,3,3,3,9,1,1
23122,1,135,1730.24,1,3,3,7,0,0
23123,1,97,765.3799999999999,1,3,3,7,0,0
23124,36,43,751.38,4,2,3,9,1,1
23125,10,38,574.88,3,2,2,7,0,0
23126,1,297,5635.99,1,4,4,9,1,1
23127,1,197,3828.3,1,4,4,9,1,1
23128,2,141,2318.06,2,3,4,9,1,1
23129,4,173,4003.65,3,4,4,11,1,1
23130,5,186,4026.3300000000004,3,4,4,11,1,1
23131,1,117,3865.03,1,3,4,8,0,0
23132,1,155,5242.1,1,3,4,8,0,0
23133,1,156,5533.65,1,3,4,8,0,0
23134,82,38,6431.110000000001,4,2,4,10,1,1
23135,1,45,5416.18,1,2,4,7,0,0
23136,4,49,511.89,3,2,2,7,0,0
23137,3,23,275.62,2,2,2,6,0,0
23138,4,83,1256.1599999999999,3,3,3,9,1,1
23139,2,28,547.55,2,2,2,6,0,0
23140,26,53,815.9000000000001,3,2,3,8,0,0
23141,1,25,272.91,1,2,2,5,0,0
23142,12,42,1240.3700000000001,3,2,3,8,0,0
23143,1,16,239.97,1,1,2,4,0,0
23144,1,277,4234.349999999999,1,4,4,9,1,1
23145,1,171,1989.9299999999998,1,4,3,8,0,0
23146,4,249,2819.23,3,4,4,11,1,1
23147,1,267,2776.85,1,4,4,9,1,1
23148,1,254,1831.2499999999998,1,4,3,8,0,0
23149,10,23,278.84000000000003,3,2,2,7,0,0
23150,4,50,393.24,3,2,2,7,0,0
23151,1,21,116.82000000000001,1,2,1,4,0,0
23152,5,162,2121.9,3,3,3,9,1,1
23153,1,91,1035.69,1,3,3,7,0,0
23154,2,238,6034.24,2,4,4,10,1,1
23155,1,149,2044.4399999999998,1,3,3,7,0,0
23156,1,207,3487.77,1,4,4,9,1,1
23157,5,164,5614.1,3,3,4,10,1,1
23158,1,258,5642.79,1,4,4,9,1,1
23159,11,226,4823.76,3,4,4,11,1,1
23160,2,78,1816.98,2,3,3,8,0,0
23161,2,99,2160.3,2,3,3,8,0,0
23162,2,176,5143.6900000000005,2,4,4,10,1,1
23163,1,211,4629.62,1,4,4,9,1,1
23164,2,93,2723.6,2,3,4,9,1,1
23165,1,298,5302.16,1,4,4,9,1,1
23166,1,257,159180.56,1,4,4,9,1,1
23167,1,240,4841.2,1,4,4,9,1,1
23168,1,355,4625.53,1,4,4,9,1,1
23169,3,348,7050.29,2,4,4,10,1,1
23170,1,457,12163.349999999999,1,4,4,9,1,1
23171,1,386,10198.24,1,4,4,9,1,1
23172,1,314,6515.209999999999,1,4,4,9,1,1
23173,1,429,25355.33,1,4,4,9,1,1
23174,2,339,12695.93,2,4,4,10,1,1
23175,1,340,9825.65,1,4,4,9,1,1
23176,1,236,4798.83,1,4,4,9,1,1
23177,1,272,5573.04,1,4,4,9,1,1
23178,1,71,958.37,1,3,3,7,0,0
23179,1,53,930.48,1,2,3,6,0,0
23180,1,50,626.04,1,2,2,5,0,0
23181,1,86,1766.57,1,3,3,7,0,0
23182,1,439,3729.7099999999996,1,4,4,9,1,1
23183,1,87,997.17,1,3,3,7,0,0
23184,1,268,4828.85,1,4,4,9,1,1
23185,3,31,116.88,2,2,1,5,0,0
23186,3,72,828.6999999999999,2,3,3,8,0,0
23187,36,78,711.55,4,3,3,10,1,1
23188,1,336,6474.169999999999,1,4,4,9,1,1
23189,1,142,3510.4,1,3,4,8,0,0
23190,1,204,2765.2,1,4,4,9,1,1
23191,1,283,3661.8899999999994,1,4,4,9,1,1
23192,2,347,6147.24,2,4,4,10,1,1
23193,1,181,4142.28,1,4,4,9,1,1
23194,1,222,4169.62,1,4,4,9,1,1
23196,1,301,2866.89,1,4,4,9,1,1
23197,1,256,2360.0499999999997,1,4,4,9,1,1
23198,1,489,5161.2,1,4,4,9,1,1
23199,1,999,31784.9,1,4,4,9,1,1
23200,1,601,14440.91,1,4,4,9,1,1
23201,1,920,28966.190000000002,1,4,4,9,1,1
23202,1,885,22295.27,1,4,4,9,1,1
23203,1,1248,43144.18,1,4,4,9,1,1
23204,1,591,7880.28,1,4,4,9,1,1
23205,1,475,5868.33,1,4,4,9,1,1
23206,1,1049,21009.13,1,4,4,9,1,1
23207,1,753,14019.8,1,4,4,9,1,1
23208,1,672,10607.86,1,4,4,9,1,1
23209,1,1109,21515.97,1,4,4,9,1,1
23210,1,196,3837.54,1,4,4,9,1,1
23211,1,161,2963.07,1,3,4,8,0,0
23212,1,189,2940.89,1,4,4,9,1,1
23213,1,153,2154.67,1,3,3,7,0,0
23214,2,103,1705.44,2,3,3,8,0,0
23215,1,211,7259.4400000000005,1,4,4,9,1,1
23216,2,44,630.73,2,2,2,6,0,0
23217,3,97,1613.82,2,3,3,8,0,0
23218,2,40,483.03,2,2,2,6,0,0
23219,2,61,568.6,2,2,2,6,0,0
23220,1,104,879.9399999999999,1,3,3,7,0,0
23221,1,148,1412.01,1,3,3,7,0,0
23222,1,77,738.4499999999999,1,3,3,7,0,0
23223,1,89,761.81,1,3,3,7,0,0
23224,1,73,660.64,1,3,2,6,0,0
23225,1,92,1246.7199999999998,1,3,3,7,0,0
23226,5,99,1656.67,3,3,3,9,1,1
23227,1,119,2077.56,1,3,3,7,0,0
23228,1,126,2109.76,1,3,3,7,0,0
23229,1,261,6780.6,1,4,4,9,1,1
23230,1,238,3259.92,1,4,4,9,1,1
23231,1,260,3008.34,1,4,4,9,1,1
23232,1,241,3500.34,1,4,4,9,1,1
23233,2,159,2116.0,2,3,3,8,0,0
23234,1,282,5134.6900000000005,1,4,4,9,1,1
23235,1,112,1998.15,1,3,3,7,0,0
23236,1,344,7201.58,1,4,4,9,1,1
23237,1,187,4347.89,1,4,4,9,1,1
23238,1,282,7891.160000000001,1,4,4,9,1,1
23239,1,187,3515.2900000000004,1,4,4,9,1,1
23240,1,553,17244.22,1,4,4,9,1,1
23241,1,368,4723.63,1,4,4,9,1,1
23242,2,217,3093.27,2,4,4,10,1,1
23243,1,505,24059.72,1,4,4,9,1,1
23244,1,117,1750.9299999999998,1,3,3,7,0,0
23245,1,910,31599.45,1,4,4,9,1,1
23247,1,314,6834.47,1,4,4,9,1,1
23249,2,88,1533.61,2,3,3,8,0,0
23250,1,118,1672.83,1,3,3,7,0,0
23251,1,125,2179.5,1,3,3,7,0,0
23252,1,145,2400.36,1,3,4,8,0,0
23253,2,72,3880.7599999999998,2,3,4,9,1,1
23254,1,307,7015.160000000001,1,4,4,9,1,1
23255,1,161,4138.72,1,3,4,8,0,0
23256,1,376,9013.37,1,4,4,9,1,1
23263,1,450,5243.44,1,4,4,9,1,1
23264,1,300,2695.81,1,4,4,9,1,1
23265,1,295,2442.29,1,4,4,9,1,1
23266,1,320,2772.57,1,4,4,9,1,1
23267,1,109,1591.95,1,3,3,7,0,0
23268,20,90,2036.99,3,3,3,9,1,1
23269,1,94,1163.1299999999999,1,3,3,7,0,0
23270,1,126,1668.07,1,3,3,7,0,0
23271,2,104,1499.3799999999999,2,3,3,8,0,0
23272,1,44,562.2199999999999,1,2,2,5,0,0
23273,1,116,1655.6499999999999,1,3,3,7,0,0
23274,1,122,2014.8999999999999,1,3,3,7,0,0
23275,1,329,4653.38,1,4,4,9,1,1
23280,1,158,1616.65,1,3,3,7,0,0
23281,1,101,1000.82,1,3,3,7,0,0
23282,4,135,757.86,3,3,3,9,1,1
23283,1,235,7060.83,1,4,4,9,1,1
23284,1,735,39767.89,1,4,4,9,1,1
23285,1,192,4574.110000000001,1,4,4,9,1,1
23286,2,225,4789.27,2,4,4,10,1,1
23287,1,200,1656.94,1,4,3,8,0,0
23288,2,189,4459.4,2,4,4,10,1,1
23289,2,195,2028.7,2,4,3,9,1,1
23290,1,216,2911.6000000000004,1,4,4,9,1,1
23291,1,198,2072.78,1,4,3,8,0,0
23292,1,228,2730.83,1,4,4,9,1,1
23293,1,557,7028.549999999999,1,4,4,9,1,1
23294,1,358,3641.8399999999997,1,4,4,9,1,1
23295,1,449,5089.219999999999,1,4,4,9,1,1
23296,1,384,6021.8,1,4,4,9,1,1
23297,17,165,6835.13,3,3,4,10,1,1
23298,1,1158,43665.64,1,4,4,9,1,1
23299,1,148,3814.13,1,3,4,8,0,0
23300,1,765,12047.289999999999,1,4,4,9,1,1
23301,1,924,16525.949999999997,1,4,4,9,1,1
23302,1,235,2248.8599999999997,1,4,3,8,0,0
23303,5,6,126.75,3,1,1,5,0,0
23304,4,9,138.45,3,1,2,6,0,0
23305,4,9,159.9,3,1,2,6,0,0
23306,4,279,4133.53,3,4,4,11,1,1
23307,1,634,6427.990000000001,1,4,4,9,1,1
23308,1,382,3279.21,1,4,4,9,1,1
23309,1,411,4575.6,1,4,4,9,1,1
23310,1,245,4997.28,1,4,4,9,1,1
23311,1,348,6526.45,1,4,4,9,1,1
23312,1,215,5972.45,1,4,4,9,1,1
23313,1,403,15897.66,1,4,4,9,1,1
23314,1,119,5100.46,1,3,4,8,0,0
23315,1,87,2192.04,1,3,3,7,0,0
23316,1,111,2521.54,1,3,4,8,0,0
23317,1,82,1787.4099999999999,1,3,3,7,0,0
23318,1,383,9536.1,1,4,4,9,1,1
23319,1,409,9511.810000000001,1,4,4,9,1,1
23320,1,335,7109.7300000000005,1,4,4,9,1,1
23321,1,633,8537.619999999999,1,4,4,9,1,1
23322,1,572,9095.26,1,4,4,9,1,1
23323,1,297,3161.4800000000005,1,4,4,9,1,1
23324,4,46,883.5500000000001,3,2,3,8,0,0
23325,12,38,770.6399999999999,3,2,3,8,0,0
23326,1,76,2237.71,1,3,3,7,0,0
23327,4,43,1055.8600000000001,3,2,3,8,0,0
23328,1,410,13314.13,1,4,4,9,1,1
23329,1,234,3061.29,1,4,4,9,1,1
23330,1,217,2306.97,1,4,4,9,1,1
23331,1,109,1062.28,1,3,3,7,0,0
23332,1,288,3574.0599999999995,1,4,4,9,1,1
23333,2,234,2736.7,2,4,4,10,1,1
23334,1,130,1491.75,1,3,3,7,0,0
23335,1,98,817.82,1,3,3,7,0,0
23336,1,85,521.33,1,3,2,6,0,0
23337,1,69,388.75,1,3,2,6,0,0
23338,1,110,927.88,1,3,3,7,0,0
23339,1,76,405.0,1,3,2,6,0,0
23340,1,151,4053.8799999999997,1,3,4,8,0,0
23341,1,121,2749.85,1,3,4,8,0,0
23342,3,164,3201.91,2,3,4,9,1,1
23343,1,483,14484.63,1,4,4,9,1,1
23344,1,723,24302.71,1,4,4,9,1,1
23345,1,176,2900.0,1,4,4,9,1,1
23346,1,185,3124.84,1,4,4,9,1,1
23347,1,100,1119.8,1,3,3,7,0,0
23348,8,176,1689.39,3,4,3,10,1,1
23349,1,339,4385.1,1,4,4,9,1,1
23350,1,307,3486.33,1,4,4,9,1,1
23351,1,357,4985.53,1,4,4,9,1,1
23352,1,213,2477.95,1,4,4,9,1,1
23353,1,329,3537.4399999999996,1,4,4,9,1,1
23354,1,325,3481.6899999999996,1,4,4,9,1,1
23355,1,790,29260.15,1,4,4,9,1,1
23356,1,478,13548.52,1,4,4,9,1,1
23357,1,102,1993.6000000000001,1,3,3,7,0,0
23358,1,91,2138.07,1,3,3,7,0,0
23359,1,79,1872.31,1,3,3,7,0,0
23360,2,114,2296.15,2,3,3,8,0,0
23365,1,169,1464.38,1,4,3,8,0,0
23366,1,195,1670.55,1,4,3,8,0,0
23367,1,283,2506.15,1,4,4,9,1,1
23368,1,234,1685.4,1,4,3,8,0,0
23369,1,126,1581.06,1,3,3,7,0,0
23370,1,152,2159.1,1,3,3,7,0,0
23371,1,185,2313.53,1,4,4,9,1,1
23372,1,148,1772.79,1,3,3,7,0,0
23373,3,100,1313.3899999999999,2,3,3,8,0,0
23374,1,134,1975.9499999999998,1,3,3,7,0,0
23375,1,104,1109.7099999999998,1,3,3,7,0,0
23376,1,156,1398.95,1,3,3,7,0,0
23377,1,134,596.74,1,3,2,6,0,0
23378,1,176,1842.42,1,4,3,8,0,0
23379,1,76,465.36,1,3,2,6,0,0
23380,1,123,997.54,1,3,3,7,0,0
23381,1,80,567.9499999999999,1,3,2,6,0,0
23382,1,223,7419.93,1,4,4,9,1,1
23388,1,154,3448.69,1,3,4,8,0,0
23389,1,238,4788.84,1,4,4,9,1,1
23390,1,164,3046.34,1,3,4,8,0,0
23391,1,87,1632.3200000000002,1,3,3,7,0,0
23392,1,114,1535.3500000000001,1,3,3,7,0,0
23393,1,235,3309.16,1,4,4,9,1,1
23394,1,150,1888.9,1,3,3,7,0,0
23395,1,215,3332.08,1,4,4,9,1,1
23396,1,197,2795.5299999999997,1,4,4,9,1,1
23397,1,222,5157.35,1,4,4,9,1,1
23398,1,70,539.6,1,3,2,6,0,0
23399,1,225,1752.35,1,4,3,8,0,0
23400,2,108,2421.84,2,3,4,9,1,1
23401,1,86,2373.62,1,3,4,8,0,0
23402,2,68,1151.03,2,3,3,8,0,0
23403,1,137,2219.11,1,3,3,7,0,0
23404,1,183,4705.31,1,4,4,9,1,1
23405,1,71,1326.33,1,3,3,7,0,0
23406,3,113,2447.6600000000003,2,3,4,9,1,1
23407,1,137,2789.0299999999997,1,3,4,8,0,0
23408,3,62,673.9200000000001,2,2,2,6,0,0
23409,5,45,827.9300000000001,3,2,3,8,0,0
23410,14,19,298.25,3,2,2,7,0,0
23411,7,57,1123.5600000000002,3,2,3,8,0,0
23412,60,77,2369.8,4,3,4,11,1,1
23413,1,59,978.9100000000001,1,2,3,6,0,0
23414,9,65,1418.55,3,2,3,8,0,0
23415,1,48,420.42999999999995,1,2,2,5,0,0
23416,1,25,184.67999999999998,1,2,2,5,0,0
23417,1,27,157.5,1,2,2,5,0,0
23418,1,79,1168.08,1,3,3,7,0,0
23419,2,87,1047.88,2,3,3,8,0,0
23420,6,32,353.45,3,2,2,7,0,0
23421,6,33,353.36,3,2,2,7,0,0
23422,2,47,477.89,2,2,2,6,0,0
23423,2,69,895.65,2,3,3,8,0,0
23424,1,136,2534.37,1,3,4,8,0,0
23425,1,59,638.87,1,2,2,5,0,0
23426,1,207,3467.55,1,4,4,9,1,1
23427,2,116,2895.98,2,3,4,9,1,1
23428,1,34,692.21,1,2,2,5,0,0
23429,1,23,400.01,1,2,2,5,0,0
23430,1,18,301.88,1,2,2,5,0,0
23431,9,75,1188.6599999999999,3,3,3,9,1,1
23432,3,74,1090.02,2,3,3,8,0,0
23433,5,92,1147.59,3,3,3,9,1,1
23434,1,200,1899.97,1,4,3,8,0,0
23435,1,99,734.7900000000001,1,3,3,7,0,0
23436,2,116,2386.14,2,3,4,9,1,1
23437,1,132,2376.13,1,3,4,8,0,0
23438,1,109,2227.42,1,3,3,7,0,0
23439,1,397,8941.61,1,4,4,9,1,1
23440,2,5,299.36,2,1,2,5,0,0
23441,2,3,9.24,2,1,1,4,0,0
23442,2,7,87.36,2,1,1,4,0,0
23444,2,80,1215.0,2,3,3,8,0,0
23445,1,102,2194.4399999999996,1,3,3,7,0,0
23446,2,3,230.24999999999997,2,1,2,5,0,0
23447,2,4,231.89999999999998,2,1,2,5,0,0
23448,10,3,41.24999999999999,3,1,1,5,0,0
23449,24,1,15.0,3,1,1,5,0,0
23451,1,52,558.12,1,2,2,5,0,0
23452,1,88,1023.7099999999999,1,3,3,7,0,0
23453,1,47,631.5799999999999,1,2,2,5,0,0
23454,1,53,762.25,1,2,3,6,0,0
23455,2,35,569.4300000000001,2,2,2,6,0,0
23456,6,37,642.4000000000001,3,2,2,7,0,0
23457,1,31,554.83,1,2,2,5,0,0
23458,1,34,837.1999999999999,1,2,3,6,0,0
23459,2,21,450.0,2,2,2,6,0,0
23460,4,47,1056.83,3,2,3,8,0,0
23461,2,95,3099.31,2,3,4,9,1,1
23462,1,58,1957.1399999999999,1,2,3,6,0,0
23463,1,8,139.39999999999998,1,1,2,4,0,0
23464,1,8,99.2,1,1,1,3,0,0
23465,2,16,247.63,2,1,2,5,0,0
23466,1,28,506.28,1,2,2,5,0,0
23467,1,11,120.08000000000001,1,1,1,3,0,0
23468,16,11,156.75,3,1,2,6,0,0
23469,1,74,1371.8400000000001,1,3,3,7,0,0
23470,4,92,1531.2,3,3,3,9,1,1
23471,7,27,626.74,3,2,2,7,0,0
23472,2,33,909.37,2,2,3,7,0,0
23473,2,51,552.85,2,2,2,6,0,0
23474,2,37,270.96,2,2,2,6,0,0
23475,2,31,242.17999999999998,2,2,2,6,0,0
23476,9,22,264.72,3,2,2,7,0,0
23477,9,13,123.47,3,1,1,5,0,0
23478,8,13,324.40000000000003,3,1,2,6,0,0
23479,1,44,880.23,1,2,3,6,0,0
23480,1,217,6794.74,1,4,4,9,1,1
23481,4,29,281.17,3,2,2,7,0,0
23482,3,39,661.02,2,2,2,6,0,0
23483,1,77,1677.6,1,3,3,7,0,0
23484,1,35,547.35,1,2,2,5,0,0
23485,1,96,6251.320000000001,1,3,4,8,0,0
23486,1,80,4345.12,1,3,4,8,0,0
23487,1,50,885.13,1,2,3,6,0,0
23489,1,159,2709.23,1,3,4,8,0,0
23490,1,102,2066.52,1,3,3,7,0,0
23491,2,79,1906.01,2,3,3,8,0,0
23492,5,28,635.38,3,2,2,7,0,0
23493,1,418,8521.08,1,4,4,9,1,1
23494,1,216,5764.56,1,4,4,9,1,1
23495,1,41,306.66,1,2,2,5,0,0
23496,2,31,154.52,2,2,2,6,0,0
23497,1,196,3677.7699999999995,1,4,4,9,1,1
23498,1,99,2378.4799999999996,1,3,4,8,0,0
23499,1,110,587.49,1,3,2,6,0,0
23500,1,98,2044.58,1,3,3,7,0,0
23501,1,112,2220.37,1,3,3,7,0,0
23502,2,94,896.41,2,3,3,8,0,0
23503,1,337,4866.8,1,4,4,9,1,1
23504,1,208,2857.64,1,4,4,9,1,1
23505,1,115,1660.04,1,3,3,7,0,0
23506,1,146,1139.2,1,3,3,7,0,0
23507,1,119,1156.51,1,3,3,7,0,0
23508,1,121,1165.97,1,3,3,7,0,0
23509,2,65,452.72,2,2,2,6,0,0
23510,1,120,1119.22,1,3,3,7,0,0
23511,2,99,1266.57,2,3,3,8,0,0
23512,2,57,977.3199999999999,2,2,3,7,0,0
23513,4,71,1126.74,3,3,3,9,1,1
23514,6,75,989.87,3,3,3,9,1,1
23515,1,71,1164.98,1,3,3,7,0,0
23516,4,42,1062.35,3,2,3,8,0,0
23517,3,63,996.38,2,2,3,7,0,0
23518,7,45,1000.64,3,2,3,8,0,0
23519,16,24,792.31,3,2,3,8,0,0
23520,4,32,604.3,3,2,2,7,0,0
23521,1,44,793.37,1,2,3,6,0,0
23522,1,32,727.4399999999999,1,2,3,6,0,0
23523,1,42,1196.3100000000002,1,2,3,6,0,0
23524,1,64,1580.13,1,2,3,6,0,0
23525,1,54,1890.0700000000002,1,2,3,6,0,0
23526,1,145,6116.6,1,3,4,8,0,0
23527,1,50,1458.56,1,2,3,6,0,0
23528,1,50,1504.49,1,2,3,6,0,0
23529,2,37,2011.9900000000002,2,2,3,7,0,0
23530,1,87,4465.97,1,3,4,8,0,0
23531,1,112,5559.11,1,3,4,8,0,0
23532,2,31,901.58,2,2,3,7,0,0
23533,1,36,998.64,1,2,3,6,0,0
23534,1,261,8656.5,1,4,4,9,1,1
23535,1,216,8475.94,1,4,4,9,1,1
23536,1,86,3465.93,1,3,4,8,0,0
23537,1,34,581.13,1,2,2,5,0,0
23538,1,32,1334.49,1,2,3,6,0,0
23539,4,41,1227.95,3,2,3,8,0,0
23540,4,14,947.0600000000001,3,1,3,7,0,0
23541,3,153,6840.41,2,3,4,9,1,1
23542,1,92,3848.8599999999997,1,3,4,8,0,0
23543,1,103,7019.01,1,3,4,8,0,0
23544,4,21,1024.03,3,2,3,8,0,0
23545,1,84,1025.6,1,3,3,7,0,0
23546,1,120,1375.5,1,3,3,7,0,0
23547,3,62,661.5,2,2,2,6,0,0
23548,2,43,451.5,2,2,2,6,0,0
23549,9,52,548.1,3,2,2,7,0,0
23550,1,64,763.1,1,2,3,6,0,0
23551,1,136,841.01,1,3,3,7,0,0
23552,1,116,3883.99,1,3,4,8,0,0
23553,1,68,6457.15,1,3,4,8,0,0
23554,2,57,4830.53,2,2,4,8,0,0
23555,1,50,4818.07,1,2,4,7,0,0
23556,2,54,4987.01,2,2,4,8,0,0
23557,1,32,3930.27,1,2,4,7,0,0
23558,2,52,4741.37,2,2,4,8,0,0
23559,1,124,1488.65,1,3,3,7,0,0
23560,2,26,502.07000000000005,2,2,2,6,0,0
23561,1,16,476.0,1,1,2,4,0,0
23562,1,43,730.37,1,2,3,6,0,0
23564,1,76,841.31,1,3,3,7,0,0
23565,1,65,592.56,1,2,2,5,0,0
23566,1,84,1164.43,1,3,3,7,0,0
23567,1,38,292.83,1,2,2,5,0,0
23568,1,49,788.77,1,2,3,6,0,0
23569,1,193,4762.21,1,4,4,9,1,1
23570,1,276,4944.37,1,4,4,9,1,1
23571,1,257,6436.61,1,4,4,9,1,1
23574,3,16,120.0,2,1,1,4,0,0
23575,1,32,367.34999999999997,1,2,2,5,0,0
23576,1,37,400.03999999999996,1,2,2,5,0,0
23578,2,14,125.72,2,1,1,4,0,0
23579,1,35,362.65,1,2,2,5,0,0
23580,2,25,236.87,2,2,2,6,0,0
23581,1,342,11837.79,1,4,4,9,1,1
23582,1,262,10456.130000000001,1,4,4,9,1,1
23583,1,326,5530.33,1,4,4,9,1,1
23597,1,32,702.6700000000001,1,2,3,6,0,0
23598,1,47,1218.48,1,2,3,6,0,0
23601,11,4,19.92,3,1,1,5,0,0
23602,28,1,2.91,3,1,1,5,0,0
23603,2,14,49.800000000000004,2,1,1,4,0,0
23604,53,2,6.64,4,1,1,6,0,0
23605,65,1,11.64,4,1,1,6,0,0
23607,16,7,13.28,3,1,1,5,0,0
23608,1,3,11.64,1,1,1,3,0,0
23609,11,1,2.91,3,1,1,5,0,0
23610,29,3,6.24,3,1,1,5,0,0
23611,1,16,99.60000000000001,1,1,1,3,0,0
23612,22,2,8.299999999999999,3,1,1,5,0,0
23613,11,6,27.39,3,1,1,5,0,0
23614,2,11,86.58000000000001,2,1,1,4,0,0
23615,3,4,9.96,2,1,1,4,0,0
23616,1,7,19.92,1,1,1,3,0,0
23617,10,1,5.82,3,1,1,5,0,0
23619,31,2,9.96,3,1,1,5,0,0
23620,21,7,24.900000000000002,3,1,1,5,0,0
23621,1,4,14.940000000000001,1,1,1,3,0,0
23623,10,6,23.28,3,1,1,5,0,0
23624,29,4,9.96,3,1,1,5,0,0
23625,7,4,44.910000000000004,3,1,1,5,0,0
23626,2,16,107.07000000000001,2,1,1,4,0,0
23627,14,2,17.43,3,1,1,5,0,0
23628,39,1,2.91,4,1,1,6,0,0
23629,14,10,59.760000000000005,3,1,1,5,0,0
23630,9,3,8.47,3,1,1,5,0,0
23632,9,10,31.200000000000003,3,1,1,5,0,0
23633,18,3,7.470000000000001,3,1,1,5,0,0
23634,3,5,14.55,2,1,1,4,0,0
23635,1,3,12.48,1,1,1,3,0,0
23636,1,7,26.19,1,1,1,3,0,0
23637,2,9,27.39,2,1,1,4,0,0
23638,16,2,5.82,3,1,1,5,0,0
23639,22,4,13.32,3,1,1,5,0,0
23640,2,8,22.410000000000004,2,1,1,4,0,0
23643,39,1,3.33,4,1,1,6,0,0
23644,1,5,16.65,1,1,1,3,0,0
23645,2,4,22.410000000000004,2,1,1,4,0,0
23646,22,5,19.92,3,1,1,5,0,0
23649,14,2,4.98,3,1,1,5,0,0
23650,2,4,9.96,2,1,1,4,0,0
23652,22,1,5.82,3,1,1,5,0,0
23654,1,4,12.450000000000001,1,1,1,3,0,0
23660,1,46,561.06,1,2,2,5,0,0
23661,1,37,426.59,1,2,2,5,0,0
23664,28,1,1.65,3,1,1,5,0,0
23681,1,132,2526.69,1,3,4,8,0,0
23691,2,38,481.5,2,2,2,6,0,0
23692,10,2,21.0,3,1,1,5,0,0
23694,1,41,165.07999999999998,1,2,2,5,0,0
23695,1,57,323.32,1,2,2,5,0,0
23697,1,35,194.58,1,2,2,5,0,0
23702,24,3,27.0,3,1,1,5,0,0
23843,1,2,336939.2,1,1,4,6,0,0
35001G,2,30,681.59,2,2,2,6,0,0
35001W,359,6,273.51000000000005,4,1,2,7,0,0
35004B,1,119,3071.61,1,3,4,8,0,0
35004C,277,47,2058.7,4,2,3,9,1,1
35004G,2,22,458.55,2,2,2,6,0,0
35004P,364,1,5.45,4,1,1,6,0,0
35095A,1,100,388.57,1,3,2,6,0,0
35095B,1,98,352.25,1,3,2,6,0,0
35241,220,44,530.49,4,2,2,8,0,0
35265,68,12,52.2,4,1,1,6,0,0
35271S,372,2,3.6100000000000003,4,1,1,6,0,0
35400,16,13,224.7,3,1,2,6,0,0
35443,15,6,6.8,3,1,1,5,0,0
35471D,1,225,987.0699999999999,1,4,3,8,0,0
35591T,20,4,6.25,3,1,1,5,0,0
35597A,369,1,1.25,4,1,1,6,0,0
35597B,369,1,1.25,4,1,1,6,0,0
35597D,99,2,17.48,4,1,1,6,0,0
35598A,19,2,26.550000000000004,3,1,1,5,0,0
35598B,9,25,460.64,3,2,2,7,0,0
35598C,16,2,5.9,3,1,1,5,0,0
35598D,6,43,493.66,3,2,2,7,0,0
35599B,6,27,551.13,3,2,2,7,0,0
35599D,6,34,553.07,3,2,2,7,0,0
35607A,325,2,7.82,4,1,1,6,0,0
35607B,86,7,18.240000000000002,4,1,1,6,0,0
35609A,364,1,2.51,4,1,1,6,0,0
35610A,360,3,15.02,4,1,1,6,0,0
35610B,362,1,30.0,4,1,1,6,0,0
35610C,362,2,32.51,4,1,1,6,0,0
35637A,12,28,440.62,3,2,2,7,0,0
35637C,12,9,100.86,3,1,1,5,0,0
35638A,19,5,82.1,3,1,1,5,0,0
35638B,19,5,128.32999999999998,3,1,1,5,0,0
35645,50,3,17.0,4,1,1,6,0,0
35646,1,94,937.25,1,3,3,7,0,0
35647,274,2,16.25,4,1,1,6,0,0
35648,1,130,1089.07,1,3,3,7,0,0
35649,2,35,156.85,2,2,2,6,0,0
35650,131,1,4.95,4,1,1,6,0,0
35651,29,59,1005.6399999999999,3,2,3,8,0,0
35653,121,52,433.19,4,2,2,8,0,0
35809A,183,62,488.89,4,2,2,8,0,0
35809B,242,3,9.18,4,1,1,6,0,0
35809a,213,9,37.33,4,1,1,6,0,0
35810A,40,75,640.92,4,3,2,9,1,1
35810B,9,28,184.88,3,2,2,7,0,0
35815P,75,5,63.28000000000001,4,1,1,6,0,0
35816P,115,2,29.64,4,1,1,6,0,0
35817P,120,2,19.86,4,1,1,6,0,0
35818B,38,3,11.780000000000001,4,1,1,6,0,0
35818P,4,19,106.97,3,2,1,6,0,0
35819B,9,24,106.81,3,2,1,6,0,0
35819P,26,7,66.55,3,1,1,5,0,0
35832,361,1,2.95,4,1,1,6,0,0
35833G,369,1,6.72,4,1,1,6,0,0
35833P,15,22,89.72,3,2,1,6,0,0
35909A,227,3,23.6,4,1,1,6,0,0
35909B,178,2,23.6,4,1,1,6,0,0
35910A,256,4,39.0,4,1,1,6,0,0
35910B,34,3,25.349999999999998,4,1,1,6,0,0
35911A,35,70,292.07,4,3,2,9,1,1
35911B,263,15,100.76,4,1,1,6,0,0
35912B,41,20,301.26,4,2,2,8,0,0
35913B,34,10,36.33,4,1,1,6,0,0
35914,51,40,219.66,4,2,2,8,0,0
35915B,77,50,257.21999999999997,4,2,2,8,0,0
35915C,235,60,316.46,4,2,2,8,0,0
35916A,52,29,67.39,4,2,1,7,0,0
35916B,52,32,76.68,4,2,1,7,0,0
35916C,52,20,107.72,4,2,1,7,0,0
35920,234,15,104.84,4,1,1,6,0,0
35921,141,24,134.48,4,2,2,8,0,0
35922,246,10,138.6,4,1,2,7,0,0
35923,9,63,690.91,3,2,2,7,0,0
35924,2,77,1786.81,2,3,3,8,0,0
35933,34,19,92.21000000000001,4,2,1,7,0,0
35953,1,132,1664.9199999999998,1,3,3,7,0,0
35954,30,54,359.6,3,2,2,7,0,0
35957,331,42,380.05,4,2,2,8,0,0
35958,365,3,10.2,4,1,1,6,0,0
35961,1,245,2641.71,1,4,4,9,1,1
35964,1,100,405.25,1,3,2,6,0,0
35965,24,70,570.09,3,3,2,8,0,0
35966,108,2,10.260000000000002,4,1,1,6,0,0
35967,1,67,252.33,1,3,2,6,0,0
35968,38,19,82.1,4,2,1,7,0,0
35970,1,462,9667.7,1,4,4,9,1,1
35971,4,90,622.18,3,3,2,8,0,0
35972,33,16,120.0,4,1,1,6,0,0
37327,30,82,842.03,3,3,3,9,1,1
37330,263,1,2.34,4,1,1,6,0,0
37333,221,17,120.99,4,2,1,7,0,0
37340,2,137,1697.03,2,3,3,8,0,0
37342,98,112,1534.69,4,3,3,10,1,1
37343,275,13,123.29999999999998,4,1,1,6,0,0
37351,264,2,9.06,4,1,1,6,0,0
37370,18,164,3872.61,3,3,4,10,1,1
37379A,324,1,7.5,4,1,1,6,0,0
37413,4,81,284.49,3,3,2,8,0,0
37423,267,3,33.18,4,1,1,6,0,0
37444A,150,18,67.13000000000001,4,2,1,7,0,0
37444B,257,3,11.8,4,1,1,6,0,0
37444C,257,9,43.050000000000004,4,1,1,6,0,0
37446,3,195,2075.09,2,4,3,9,1,1
37447,2,121,1337.1699999999998,2,3,3,8,0,0
37448,1,199,2281.13,1,4,3,8,0,0
37449,2,179,5573.94,2,4,4,10,1,1
37450,1,146,2222.59,1,3,3,7,0,0
37461,369,1,1.25,4,1,1,6,0,0
37462E,4,12,13.1,3,1,1,5,0,0
37464,357,2,3.75,4,1,1,6,0,0
37467,60,17,130.26999999999998,4,2,2,8,0,0
37468,51,13,32.42,4,1,1,6,0,0
37471,58,3,30.43,4,1,1,6,0,0
37474,368,1,9.95,4,1,1,6,0,0
37475,7,43,671.93,3,2,2,7,0,0
37476,50,26,399.02,4,2,2,8,0,0
37479B,177,21,78.09,4,2,1,7,0,0
37479P,32,32,146.91,4,2,2,8,0,0
37482P,241,47,354.03,4,2,2,8,0,0
37487B,241,2,19.72,4,1,1,6,0,0
37488A,241,3,10.92,4,1,1,6,0,0
37489A,19,14,14.43,3,1,1,5,0,0
37489B,19,12,16.77,3,1,1,5,0,0
37489C,86,8,13.65,4,1,1,6,0,0
37489D,5,16,17.16,3,1,1,5,0,0
37491A,39,4,19.81,4,1,1,6,0,0
37491B,144,1,6.6,4,1,1,6,0,0
37491C,144,1,13.2,4,1,1,6,0,0
37491D,144,2,9.879999999999999,4,1,1,6,0,0
37495,1,104,1805.99,1,3,3,7,0,0
37500,1,116,2385.53,1,3,4,8,0,0
37501,108,50,920.73,4,2,3,9,1,1
37503,360,1,10.75,4,1,1,6,0,0
37509,369,2,5.1,4,1,1,6,0,0
40001,27,62,687.39,3,2,2,7,0,0
40003,186,15,179.23,4,1,2,7,0,0
40005B,17,4,10.2,3,1,1,5,0,0
40016,79,97,2136.34,4,3,3,10,1,1
40046A,54,6,62.5,4,1,1,6,0,0
44089A,12,4,6.3,3,1,1,5,0,0
44089C,77,6,10.08,4,1,1,6,0,0
44091A,143,3,3.78,4,1,1,6,0,0
44092B,95,5,11.899999999999999,4,1,1,6,0,0
44092C,51,8,18.7,4,1,1,6,0,0
44228,109,2,30.599999999999998,4,1,1,6,0,0
44234,1,34,156.24,1,2,2,5,0,0
44235,2,13,200.45999999999998,2,1,2,5,0,0
44236,110,6,56.52,4,1,1,6,0,0
44242A,152,1,9.48,4,1,1,6,0,0
44242B,74,3,50.28,4,1,1,6,0,0
44265,302,1,8.5,4,1,1,6,0,0
45013,47,2,8.850000000000001,4,1,1,6,0,0
46000M,2,138,1584.1000000000001,2,3,3,8,0,0
46000P,96,6,76.5,4,1,1,6,0,0
46000R,2,38,149.35,2,2,2,6,0,0
46000S,1,188,2320.0,1,4,4,9,1,1
46000U,6,26,133.75,3,2,2,7,0,0
46115B,280,2,2.2800000000000002,4,1,1,6,0,0
46118,1,46,317.16999999999996,1,2,2,5,0,0
46126A,206,8,69.84,4,1,1,6,0,0
46138B,26,14,54.199999999999996,3,1,1,5,0,0
46775D,5,39,720.93,3,2,3,8,0,0
46776A,1,70,651.95,1,3,2,6,0,0
46776B,1,88,679.67,1,3,2,6,0,0
46776C,1,59,492.79,1,2,2,5,0,0
46776D,1,37,378.29,1,2,2,5,0,0
46776E,1,38,288.43,1,2,2,5,0,0
46776F,1,89,883.12,1,3,3,7,0,0
46776a,39,1,20.65,4,1,1,6,0,0
46776b,39,1,4.13,4,1,1,6,0,0
46776e,39,1,4.13,4,1,1,6,0,0
46776f,39,1,28.91,4,1,1,6,0,0
47013A,234,4,3.0399999999999996,4,1,1,6,0,0
47013C,172,13,14.41,4,1,1,6,0,0
47016,38,1,4.2,4,1,1,6,0,0
47021G,170,27,309.29999999999995,4,2,2,8,0,0
47310M,1,121,570.4499999999999,1,3,2,6,0,0
47341A,185,5,38.75,4,1,1,6,0,0
47341B,9,11,56.25,3,1,1,5,0,0
47343A,124,14,145.17,4,1,2,7,0,0
47344B,191,6,43.66,4,1,1,6,0,0
47348A,99,15,50.31,4,1,1,6,0,0
47351B,33,10,356.9,4,1,2,7,0,0
47367B,45,43,376.27000000000004,4,2,2,8,0,0
47369A,8,20,93.19,3,2,1,6,0,0
47369B,8,22,97.13,3,2,1,6,0,0
47420,5,13,38.38,3,1,1,5,0,0
47421,2,55,395.09999999999997,2,2,2,6,0,0
47422,8,46,261.71999999999997,3,2,2,7,0,0
47469,1,13,256.81,1,1,2,4,0,0
47471,2,39,191.18,2,2,2,6,0,0
47480,1,86,1277.4699999999998,1,3,3,7,0,0
47481,10,23,172.64,3,2,2,7,0,0
47503A,12,165,1289.28,3,3,3,9,1,1
47503H,3,37,112.81,2,2,1,5,0,0
47503J,367,2,23.85,4,1,1,6,0,0
47504H,1,119,969.38,1,3,3,7,0,0
47504K,30,213,2058.93,3,4,3,10,1,1
47518F,11,28,113.64,3,2,1,6,0,0
47518f,44,5,20.73,4,1,1,6,0,0
47556B,235,2,6045.0,4,1,4,9,1,1
47559B,1,289,2626.15,1,4,4,9,1,1
47559b,2,28,342.65,2,2,2,6,0,0
47563A,1,106,557.76,1,3,2,6,0,0
47566,1,1705,100705.68000000001,1,4,4,9,1,1
47566B,5,372,14983.07,3,4,4,11,1,1
47566b,31,102,1651.1499999999999,3,3,3,9,1,1
47567B,4,138,3502.4500000000003,3,3,4,10,1,1
47570B,255,31,1727.23,4,2,3,9,1,1
47570b,318,2,42.019999999999996,4,1,1,6,0,0
47574A,63,115,667.45,4,3,2,9,1,1
47574B,206,2,17.0,4,1,1,6,0,0
47578A,2,45,202.53,2,2,2,6,0,0
47579,369,1,2.1,4,1,1,6,0,0
47580,1,112,1152.4199999999998,1,3,3,7,0,0
47585A,8,83,1129.44,3,3,3,9,1,1
47586A,17,8,53.55,3,1,1,5,0,0
47589,200,3,70.85000000000001,4,1,1,6,0,0
47590A,3,393,10617.45,2,4,4,10,1,1
47590B,1,397,12196.02,1,4,4,9,1,1
47590b,27,9,129.48,3,1,1,5,0,0
47591B,310,56,344.78999999999996,4,2,2,8,0,0
47591D,1,441,6064.15,1,4,4,9,1,1
47591b,2,1,4.13,2,1,1,4,0,0
47591d,10,56,672.24,3,2,2,7,0,0
47593A,255,12,14.37,4,1,1,6,0,0
47593B,2,245,946.13,2,4,3,9,1,1
47593b,39,1,4.9799999999999995,4,1,1,6,0,0
47594A,15,55,217.39,3,2,2,7,0,0
47594B,32,59,322.34999999999997,4,2,2,8,0,0
47599A,7,166,4662.1,3,3,4,10,1,1
47599B,7,120,2931.52,3,3,4,10,1,1
48111,1,234,7748.83,1,4,4,9,1,1
48116,1,203,9112.78,1,4,4,9,1,1
48129,1,209,6168.99,1,4,4,9,1,1
48138,1,623,25707.1,1,4,4,9,1,1
48173C,2,191,10066.06,2,4,4,10,1,1
48173c,221,7,252.95000000000002,4,1,2,7,0,0
48184,1,410,14371.7,1,4,4,9,1,1
48185,1,368,28443.71,1,4,4,9,1,1
48187,1,602,24324.64,1,4,4,9,1,1
48188,3,290,12155.02,2,4,4,10,1,1
48189,228,17,451.10999999999996,4,2,2,8,0,0
48194,1,594,22162.420000000002,1,4,4,9,1,1
51008,1,23,1697.45,1,2,3,6,0,0
51014A,1,240,2079.98,1,4,3,8,0,0
51014C,1,178,1495.4299999999998,1,4,3,8,0,0
51014L,1,151,1145.22,1,3,3,7,0,0
51014c,39,1,0.83,4,1,1,6,0,0
51020A,227,19,116.91,4,2,1,7,0,0
51020B,227,16,70.85999999999999,4,1,1,6,0,0
62018,3,61,5716.85,2,2,4,8,0,0
62043B,204,6,14.94,4,1,1,6,0,0
62074B,150,4,6.72,4,1,1,6,0,0
62086A,169,14,171.6,4,1,2,7,0,0
62094B,309,8,63.209999999999994,4,1,1,6,0,0
62096A,288,8,132.5,4,1,2,7,0,0
62096B,277,1,2.5,4,1,1,6,0,0
62097B,201,3,7.469999999999999,4,1,1,6,0,0
70006,1,120,1865.6299999999999,1,3,3,7,0,0
70007,1,108,982.76,1,3,3,7,0,0
71038,12,49,1272.2,3,2,3,8,0,0
71050,7,6,11.549999999999999,3,1,1,5,0,0
71053,1,342,8581.59,1,4,4,9,1,1
71101E,19,22,280.2,3,2,2,7,0,0
71143,149,37,196.35999999999999,4,2,2,8,0,0
71215,197,2,4.62,4,1,1,6,0,0
71270,1,49,338.73,1,2,2,5,0,0
71279,30,42,576.07,3,2,2,7,0,0
71403,24,33,286.91,3,2,2,7,0,0
71406C,10,21,57.96,3,2,1,6,0,0
71459,1,451,10964.77,1,4,4,9,1,1
71477,1,347,24102.18,1,4,4,9,1,1
71495A,16,8,40.379999999999995,3,1,1,5,0,0
71495B,16,8,61.05,3,1,1,5,0,0
71496A,37,12,80.96000000000001,4,1,1,6,0,0
71496B,37,4,7.37,4,1,1,6,0,0
71510,15,8,36.519999999999996,3,1,1,5,0,0
72024U,166,3,15.120000000000001,4,1,1,6,0,0
72051S,240,13,89.94999999999999,4,1,1,6,0,0
72122,1,61,336.73999999999995,1,2,2,5,0,0
72127,16,30,210.61,3,2,2,7,0,0
72128,1,36,152.04999999999998,1,2,2,5,0,0
72130,9,27,133.34,3,2,2,7,0,0
72131,15,18,238.34999999999997,3,2,2,7,0,0
72132,12,12,54.599999999999994,3,1,1,5,0,0
72133,2,16,63.51,2,1,1,4,0,0
72134,2,11,58.62,2,1,1,4,0,0
72140E,55,9,27.199999999999996,4,1,1,6,0,0
72225C,11,17,165.6,3,2,2,7,0,0
72232,1,65,630.23,1,2,2,5,0,0
72349B,1,114,1490.89,1,3,3,7,0,0
72349b,1,82,658.51,1,3,2,6,0,0
72351A,1,153,2528.15,1,3,4,8,0,0
72351B,2,189,4018.35,2,4,4,10,1,1
72351a,44,12,62.269999999999996,4,1,1,6,0,0
72369A,11,5,39.92,3,1,1,5,0,0
72586,8,84,333.78999999999996,3,3,2,8,0,0
72598,1,93,605.89,1,3,2,6,0,0
72709,26,7,37.4,3,1,1,5,0,0
72741,1,300,8261.25,1,4,4,9,1,1
72760B,1,155,4169.94,1,3,4,8,0,0
72780,1,20,116.44999999999999,1,2,1,4,0,0
72783,1,2,33.6,1,1,1,3,0,0
72798C,310,3,11.549999999999999,4,1,1,6,0,0
72799C,3,19,129.47,2,2,1,5,0,0
72799E,1,77,937.6400000000001,1,3,3,7,0,0
72799F,15,30,424.08000000000004,3,2,2,7,0,0
72800B,2,38,290.8,2,2,2,6,0,0
72800C,2,35,264.82,2,2,2,6,0,0
72800D,11,31,229.22,3,2,2,7,0,0
72800E,1,136,1213.29,1,3,3,7,0,0
72801C,1,19,180.65,1,2,2,5,0,0
72801D,1,18,113.21,1,2,1,4,0,0
72801G,24,13,72.46,3,1,1,5,0,0
72801c,3,25,95.94,2,2,1,5,0,0
72801d,2,44,184.7,2,2,2,6,0,0
72802A,9,67,1350.28,3,3,3,9,1,1
72802B,35,88,2655.72,4,3,4,11,1,1
72802C,9,109,3272.25,3,3,4,10,1,1
72802a,154,2,58.029999999999994,4,1,1,6,0,0
72802c,17,1,8.29,3,1,1,5,0,0
72803A,34,43,739.47,4,2,3,9,1,1
72803b,372,1,8.47,4,1,1,6,0,0
72807A,16,112,1888.07,3,3,3,9,1,1
72807B,16,111,1843.46,3,3,3,9,1,1
72807C,9,167,3661.75,3,3,4,10,1,1
72807a,14,5,66.32,3,1,1,5,0,0
72807b,239,4,33.16,4,1,1,6,0,0
72807c,17,5,41.449999999999996,3,1,1,5,0,0
72811,2,8,78.92999999999999,2,1,1,4,0,0
72812,1,11,116.06,1,1,1,3,0,0
72815,318,3,30.97,4,1,1,6,0,0
72816,53,70,1036.27,4,3,3,10,1,1
72817,16,162,1262.27,3,3,3,9,1,1
72818,39,77,847.9,4,3,3,10,1,1
72819,1,43,509.07,1,2,2,5,0,0
72821,302,4,18.15,4,1,1,6,0,0
75011,11,12,138.76,3,1,2,6,0,0
75013B,327,6,41.24999999999999,4,1,1,6,0,0
75049L,2,225,7032.179999999999,2,4,4,10,1,1
75131,249,15,529.21,4,1,2,7,0,0
75172,158,8,85.31,4,1,1,6,0,0
75178,3,13,218.87,2,1,2,5,0,0
77079,181,1,2.12,4,1,1,6,0,0
77101A,264,22,428.19,4,2,2,8,0,0
78033,65,10,203.15,4,1,2,7,0,0
78034B,69,6,15.6,4,1,1,6,0,0
78124,11,18,257.75,3,2,2,7,0,0
79000,88,129,3383.79,4,3,4,11,1,1
79026B,205,9,10.61,4,1,1,6,0,0
79030D,29,48,352.96,3,2,2,7,0,0
79030G,189,67,735.8299999999999,4,3,3,10,1,1
79051A,3,41,293.31,2,2,2,6,0,0
79062D,115,4,19.4,4,1,1,6,0,0
79063C,1,14,43.65,1,1,1,3,0,0
79063D,12,11,35.33,3,1,1,5,0,0
79066K,1,149,699.54,1,3,3,7,0,0
79066k,19,10,27.77,3,1,1,5,0,0
79067,353,38,719.69,4,2,3,9,1,1
79071B,179,11,59.0,4,1,1,6,0,0
79144B,2,53,103.64999999999999,2,2,1,5,0,0
79144C,2,51,98.53999999999999,2,2,1,5,0,0
79149B,4,8,7.56,3,1,1,5,0,0
79151B,11,2,4.62,3,1,1,5,0,0
79157B,4,2,3.4,3,1,1,5,0,0
79157V,36,3,4.25,4,1,1,6,0,0
79160,1,52,818.93,1,2,3,6,0,0
79161A,17,2,5.9,3,1,1,5,0,0
79163,83,38,631.71,4,2,2,8,0,0
79164,32,20,704.9100000000001,4,2,3,9,1,1
79190A,1,64,180.62,1,2,2,5,0,0
79190B,1,59,295.08,1,2,2,5,0,0
79190D,7,47,126.97999999999999,3,2,1,6,0,0
79191B,1,31,148.5,1,2,2,5,0,0
79191C,2,78,946.8299999999999,2,3,3,8,0,0
79191D,1,17,47.809999999999995,1,2,1,4,0,0
79192A,310,2,3.75,4,1,1,6,0,0
79302M,1,62,1037.54,1,2,3,6,0,0
79320,338,1,4.95,4,1,1,6,0,0
79321,1,667,54467.46,1,4,4,9,1,1
79323B,301,3,108.0,4,1,1,6,0,0
79323P,301,3,81.0,4,1,1,6,0,0
79323W,324,1,54.0,4,1,1,6,0,0
79329,243,2,12.18,4,1,1,6,0,0
79331,247,3,17.5,4,1,1,6,0,0
79336,98,3,13.680000000000003,4,1,1,6,0,0
79337,154,11,262.24,4,1,2,7,0,0
79403,7,15,85.52,3,1,1,5,0,0
79406,2,8,34.12,2,1,1,4,0,0
81950B,114,8,33.93,4,1,1,6,0,0
81950V,149,6,8.889999999999999,4,1,1,6,0,0
81952B,136,9,38.0,4,1,1,6,0,0
81952V,12,24,69.73,3,2,1,6,0,0
81953B,145,3,2.09,4,1,1,6,0,0
81953P,142,3,5.32,4,1,1,6,0,0
82001S,2,131,5775.74,2,3,4,9,1,1
82001s,1,27,910.12,1,2,3,6,0,0
82011A,26,12,67.5,3,1,1,5,0,0
82011B,16,21,146.85,3,2,2,7,0,0
82011C,16,20,172.05,3,2,2,7,0,0
82095,157,30,356.11,4,2,2,8,0,0
82482,1,1118,23694.81,1,4,4,9,1,1
82483,2,583,16480.77,2,4,4,10,1,1
82484,1,696,36201.17,1,4,4,9,1,1
82486,1,626,19053.12,1,4,4,9,1,1
82494L,1,926,20551.74,1,4,4,9,1,1
82494l,2,61,2211.6,2,2,3,7,0,0
82551,1,354,4548.09,1,4,4,9,1,1
82552,1,364,4680.63,1,4,4,9,1,1
82567,1,291,1412.27,1,4,3,8,0,0
82578,2,306,1225.5500000000002,2,4,3,9,1,1
82580,1,636,3601.31,1,4,4,9,1,1
82581,1,410,2167.05,1,4,3,8,0,0
82582,1,441,8902.890000000001,1,4,4,9,1,1
82583,1,617,17180.52,1,4,4,9,1,1
82599,216,141,1217.73,4,3,3,10,1,1
82600,1,549,12908.580000000002,1,4,4,9,1,1
82605,267,3,29.400000000000002,4,1,1,6,0,0
82613A,148,18,93.63,4,2,1,7,0,0
82613B,3,112,509.89,2,3,2,7,0,0
82613C,7,97,453.03,3,3,2,8,0,0
82613D,3,112,543.89,2,3,2,7,0,0
82613a,184,1,2.46,4,1,1,6,0,0
82613b,154,4,9.94,4,1,1,6,0,0
82613c,44,4,12.399999999999999,4,1,1,6,0,0
82615,373,1,91.8,4,1,1,6,0,0
82616B,2,74,516.94,2,3,2,7,0,0
82616C,2,86,505.19,2,3,2,7,0,0
84006,1,106,850.4,1,3,3,7,0,0
84012,1,116,1385.99,1,3,3,7,0,0
84016,86,2,12.16,4,1,1,6,0,0
84029E,1,435,22401.43,1,4,4,9,1,1
84029G,1,463,16222.04,1,4,4,9,1,1
84030E,1,336,6465.69,1,4,4,9,1,1
84030e,2,41,877.76,2,2,3,7,0,0
84031A,1,166,2000.16,1,3,3,7,0,0
84031B,1,144,1481.32,1,3,3,7,0,0
84031a,39,1,16.63,4,1,1,6,0,0
84031b,39,1,16.63,4,1,1,6,0,0
84032A,1,315,3473.48,1,4,4,9,1,1
84032B,1,259,2563.94,1,4,4,9,1,1
84033,86,7,37.95,4,1,1,6,0,0
84050,39,259,4784.48,4,4,4,12,1,1
84051,4,25,216.06,3,2,2,7,0,0
84077,1,540,14095.769999999999,1,4,4,9,1,1
84078A,2,163,17611.55,2,3,4,9,1,1
84086B,3,8,50.150000000000006,2,1,1,4,0,0
84086C,9,53,634.07,3,2,2,7,0,0
84192,5,25,143.75,3,2,2,7,0,0
84199,4,31,29.19,3,2,1,6,0,0
84201B,15,2,2.47,3,1,1,5,0,0
84201C,104,1,0.95,4,1,1,6,0,0
84206A,15,3,4.5600000000000005,3,1,1,5,0,0
84206B,20,1,0.95,3,1,1,5,0,0
84206C,15,2,1.52,3,1,1,5,0,0
84212,3,111,4934.87,2,3,4,9,1,1
84218,254,41,223.10999999999999,4,2,2,8,0,0
84226,185,10,36.21,4,1,1,6,0,0
84227,270,1,0.42,4,1,1,6,0,0
84228,11,28,124.50999999999999,3,2,1,6,0,0
84231,36,20,72.63,4,2,1,7,0,0
84247E,6,50,460.79,3,2,2,7,0,0
84247G,148,32,158.63,4,2,2,8,0,0
84247K,54,10,100.30000000000001,4,1,1,6,0,0
84247L,235,19,62.06,4,2,1,7,0,0
84247N,12,18,64.9,3,2,1,6,0,0
84249A,1,27,80.46,1,2,1,4,0,0
84251B,75,54,73.06,4,2,1,7,0,0
84251C,127,40,53.88,4,2,1,7,0,0
84251G,2,53,74.7,2,2,1,5,0,0
84270,368,4,3.5700000000000003,4,1,1,6,0,0
84279B,176,72,812.2,4,3,3,10,1,1
84279P,8,133,1636.96,3,3,3,9,1,1
84306,262,9,88.22,4,1,1,6,0,0
84313B,253,39,518.61,4,2,2,8,0,0
84313C,191,43,1165.9099999999999,4,2,3,9,1,1
84341B,24,40,282.38,3,2,2,7,0,0
84347,1,453,26785.43,1,4,4,9,1,1
84352,79,26,645.15,4,2,2,8,0,0
84356,1,82,2124.15,1,3,3,7,0,0
84358,123,13,312.7,4,1,2,7,0,0
84360,4,20,434.12,3,2,2,7,0,0
84375,1,519,9431.45,1,4,4,9,1,1
84378,1,689,8630.9,1,4,4,9,1,1
84380,1,696,8260.21,1,4,4,9,1,1
84387A,142,1,21.45,4,1,1,6,0,0
84388,234,6,13.14,4,1,1,6,0,0
84402B,141,3,48.19,4,1,1,6,0,0
84406B,4,290,7819.820000000001,3,4,4,11,1,1
84415A,169,2,15.0,4,1,1,6,0,0
84415B,185,3,20.0,4,1,1,6,0,0
84422,84,16,262.89,4,1,2,7,0,0
84429A,1,21,185.45000000000002,1,2,2,5,0,0
84452,51,17,66.3,4,2,1,7,0,0
84457,30,26,113.41,3,2,1,6,0,0
84459A,22,94,1149.07,3,3,3,9,1,1
84459B,246,91,1079.67,4,3,3,10,1,1
84461,233,15,119.85,4,1,1,6,0,0
84462,239,6,15.0,4,1,1,6,0,0
84465,36,7,29.5,4,1,1,6,0,0
84466,148,10,57.5,4,1,1,6,0,0
84497,24,7,48.75,3,1,1,5,0,0
84499,340,2,5.949999999999999,4,1,1,6,0,0
84507B,94,22,118.72999999999999,4,2,1,7,0,0
84507C,48,30,193.57999999999998,4,2,2,8,0,0
84508A,80,37,3450.6000000000004,4,2,4,10,1,1
84508B,12,31,160.64999999999998,3,2,2,7,0,0
84508C,22,25,157.5,3,2,2,7,0,0
84509A,1,233,3451.03,1,4,4,9,1,1
84509B,1,79,806.04,1,3,3,7,0,0
84509C,4,51,502.69,3,2,2,7,0,0
84509E,2,23,183.45,2,2,2,6,0,0
84509G,1,66,950.49,1,3,3,7,0,0
84509a,1,68,775.84,1,3,3,7,0,0
84509b,27,4,37.3,3,1,1,5,0,0
84509c,5,27,322.22,3,2,2,7,0,0
84509g,213,2,14.92,4,1,1,6,0,0
84510A,1,240,1637.82,1,4,3,8,0,0
84510C,4,54,213.82999999999998,3,2,2,7,0,0
84510E,4,16,48.29,3,1,1,5,0,0
84510a,165,40,130.48,4,2,2,8,0,0
84510c,5,23,98.7,3,2,1,6,0,0
84510e,239,1,2.46,4,1,1,6,0,0
84519A,1,88,905.55,1,3,3,7,0,0
84519B,1,126,774.55,1,3,3,7,0,0
84520B,281,80,508.36999999999995,4,3,2,9,1,1
84522,17,12,36.76,3,1,1,5,0,0
84527,15,8,95.1,3,1,1,5,0,0
84531A,235,29,76.69,4,2,1,7,0,0
84531B,235,28,87.56,4,2,1,7,0,0
84534B,324,10,50.72,4,1,1,6,0,0
84534b,353,2,3.32,4,1,1,6,0,0
84535A,215,21,186.56,4,2,2,8,0,0
84535B,2,157,911.95,2,3,3,8,0,0
84536A,1,342,1423.34,1,4,3,8,0,0
84536B,3,180,908.3,2,4,3,9,1,1
84536a,19,4,11.060000000000002,3,1,1,5,0,0
84536b,365,1,4.050000000000001,4,1,1,6,0,0
84539,153,2,42.9,4,1,1,6,0,0
84548,154,4,36.3,4,1,1,6,0,0
84549,31,7,69.38,3,1,1,5,0,0
84550,14,1,1.65,3,1,1,5,0,0
84551,64,2,21.449999999999996,4,1,1,6,0,0
84558A,5,81,996.2600000000001,3,3,3,9,1,1
84558a,1,5,29.310000000000002,1,1,1,3,0,0
84559A,1,94,375.60999999999996,1,3,2,6,0,0
84559B,37,56,220.69,4,2,2,8,0,0
84559a,166,22,48.379999999999995,4,2,1,7,0,0
84559b,80,20,38.33,4,2,1,7,0,0
84562A,292,3,23.85,4,1,1,6,0,0
84563A,207,35,369.84000000000003,4,2,2,8,0,0
84563B,174,38,358.1,4,2,2,8,0,0
84568,1,147,2923.13,1,3,4,8,0,0
84569A,4,65,355.84,3,2,2,7,0,0
84569B,263,19,119.65,4,2,1,7,0,0
84569C,259,1,1.25,4,1,1,6,0,0
84569D,1,98,561.87,1,3,2,6,0,0
84575A,234,5,45.25,4,1,1,6,0,0
84576,143,17,148.32,4,2,2,8,0,0
84580,2,165,1486.18,2,3,3,8,0,0
84581,5,90,717.21,3,3,3,9,1,1
84584,152,30,314.51,4,2,2,8,0,0
84592,9,22,241.24000000000004,3,2,2,7,0,0
84593,277,1,14.750000000000002,4,1,1,6,0,0
84595E,129,23,157.97,4,2,2,8,0,0
84596B,1,523,2577.24,1,4,4,9,1,1
84596E,253,79,412.1,4,3,2,9,1,1
84596F,1,436,1958.72,1,4,3,8,0,0
84596G,1,245,949.92,1,4,3,8,0,0
84596J,201,68,296.45,4,3,2,9,1,1
84596L,83,172,629.8,4,4,2,10,1,1
84596b,353,5,17.57,4,1,1,6,0,0
84596e,360,6,25.099999999999998,4,1,1,6,0,0
84596f,5,12,39.36,3,1,1,5,0,0
84596g,296,1,7.38,4,1,1,6,0,0
84596l,198,1,2.46,4,1,1,6,0,0
84597B,174,5,51.25,4,1,1,6,0,0
84597C,190,13,57.5,4,1,1,6,0,0
84598,1,100,606.52,1,3,2,6,0,0
84600,1,26,454.84000000000003,1,2,2,5,0,0
84609,4,21,787.59,3,2,3,8,0,0
84613A,310,3,27.900000000000002,4,1,1,6,0,0
84613C,367,1,4.65,4,1,1,6,0,0
84614A,371,1,11.9,4,1,1,6,0,0
84616,18,11,594.17,3,1,2,6,0,0
84617,25,3,38.25,3,1,1,5,0,0
84620,359,1,11.9,4,1,1,6,0,0
84625A,2,44,628.78,2,2,2,6,0,0
84625C,67,40,578.06,4,2,2,8,0,0
84629,116,11,154.95,4,1,2,7,0,0
84631,162,26,372.38,4,2,2,8,0,0
84632,141,6,419.65000000000003,4,1,2,7,0,0
84637,77,83,619.59,4,3,2,9,1,1
84638,51,37,331.5,4,2,2,8,0,0
84658,3,22,426.13,2,2,2,6,0,0
84659A,19,90,678.8199999999999,3,3,2,8,0,0
84660A,67,44,787.99,4,2,3,9,1,1
84660B,99,40,734.86,4,2,3,9,1,1
84660C,93,45,693.32,4,2,2,8,0,0
84660a,171,2,29.84,4,1,1,6,0,0
84660b,94,2,15.08,4,1,1,6,0,0
84660c,121,16,134.92,4,1,2,7,0,0
84661A,2,20,167.79,2,2,2,6,0,0
84661B,2,29,300.24,2,2,2,6,0,0
84661C,3,14,104.84,2,1,1,4,0,0
84661a,206,1,4.96,4,1,1,6,0,0
84661b,54,1,4.96,4,1,1,6,0,0
84663A,19,37,383.23,3,2,2,7,0,0
84665,18,20,743.75,3,2,3,8,0,0
84666,234,4,94.80000000000001,4,1,1,6,0,0
84673A,15,43,63.720000000000006,3,2,1,6,0,0
84673B,4,66,156.63,3,3,2,8,0,0
84674,4,48,481.70000000000005,3,2,2,7,0,0
84675,326,2,26.55,4,1,1,6,0,0
84678,262,15,252.08999999999997,4,1,2,7,0,0
84679,4,2,55.7,3,1,1,5,0,0
84683,220,12,162.20000000000002,4,1,2,7,0,0
84685,202,22,181.08,4,2,2,8,0,0
84686,152,8,66.39,4,1,1,6,0,0
84687,25,34,528.23,3,2,2,7,0,0
84688,149,17,258.32,4,2,2,8,0,0
84689,220,2,9.95,4,1,1,6,0,0
84691,193,4,174.5,4,1,2,7,0,0
84692,1,586,4342.5,1,4,4,9,1,1
84705C,220,1,15.0,4,1,1,6,0,0
84706D,202,4,29.599999999999998,4,1,1,6,0,0
84706F,12,10,47.2,3,1,1,5,0,0
84707A,1,45,695.23,1,2,3,6,0,0
84707B,1,18,210.54999999999998,1,2,2,5,0,0
84708B,2,19,326.35,2,2,2,6,0,0
84709B,166,11,119.0,4,1,1,6,0,0
84711A,6,17,221.79999999999998,3,2,2,7,0,0
84711B,2,13,186.64,2,1,2,5,0,0
84712B,9,20,231.56,3,2,2,7,0,0
84715,240,3,47.2,4,1,1,6,0,0
84723,123,6,97.95,4,1,1,6,0,0
84725,78,18,39.65,4,2,1,7,0,0
84731,131,2,2.04,4,1,1,6,0,0
84732B,113,2,8.58,4,1,1,6,0,0
84732D,113,2,4.29,4,1,1,6,0,0
84741C,226,14,117.0,4,1,1,6,0,0
84743C,253,1,1.25,4,1,1,6,0,0
84744,24,20,140.02,3,2,2,7,0,0
84745A,227,5,13.44,4,1,1,6,0,0
84745B,227,5,13.44,4,1,1,6,0,0
84746,142,9,38.31,4,1,1,6,0,0
84748,10,61,585.86,3,2,2,7,0,0
84750A,246,3,99.44999999999999,4,1,1,6,0,0
84750B,234,13,55.379999999999995,4,1,1,6,0,0
84751B,242,9,39.480000000000004,4,1,1,6,0,0
84754,77,63,878.16,4,2,3,9,1,1
84755,1,633,10563.1,1,4,4,9,1,1
84760S,211,8,62.349999999999994,4,1,1,6,0,0
84763,196,57,748.34,4,2,3,9,1,1
84766,36,17,377.95,4,2,2,8,0,0
84773,369,1,8.850000000000001,4,1,1,6,0,0
84789,141,48,644.47,4,2,2,8,0,0
84792,1,245,4093.6600000000003,1,4,4,9,1,1
84795B,32,48,1390.64,4,2,3,9,1,1
84795C,312,1,15.9,4,1,1,6,0,0
84795b,9,14,266.78,3,1,2,6,0,0
84796A,7,43,568.13,3,2,2,7,0,0
84796B,32,124,2393.5899999999997,4,3,4,11,1,1
84796a,108,12,141.10999999999999,4,1,2,7,0,0
84798A,72,5,89.25,4,1,1,6,0,0
84798B,171,4,38.25,4,1,1,6,0,0
84799,240,12,195.64,4,1,2,7,0,0
84800L,189,23,679.9200000000001,4,2,2,8,0,0
84800M,104,12,179.38,4,1,2,7,0,0
84800S,89,10,130.07,4,1,2,7,0,0
84801A,17,5,96.60000000000001,3,1,1,5,0,0
84801B,247,3,46.2,4,1,1,6,0,0
84802A,355,1,3.38,4,1,1,6,0,0
84802B,284,1,6.76,4,1,1,6,0,0
84803A,299,1,5.07,4,1,1,6,0,0
84803B,121,5,33.8,4,1,1,6,0,0
84804A,4,8,180.58,3,1,2,6,0,0
84804B,2,6,188.37000000000003,2,1,2,5,0,0
84805A,4,4,60.0,3,1,1,5,0,0
84805B,2,3,52.5,2,1,1,4,0,0
84806A,2,11,96.88999999999999,2,1,1,4,0,0
84806B,4,20,411.55999999999995,3,2,2,7,0,0
84809A,171,9,119.70000000000002,4,1,1,6,0,0
84809B,288,1,37.800000000000004,4,1,1,6,0,0
84813,3,39,1397.74,2,2,3,7,0,0
84816,112,15,759.0500000000001,4,1,3,8,0,0
84817,1,61,788.34,1,2,3,6,0,0
84818,40,106,1563.05,4,3,3,10,1,1
84819,1,64,968.79,1,2,3,6,0,0
84820,1,32,508.43,1,2,2,5,0,0
84821,1,41,427.54999999999995,1,2,2,5,0,0
84823,305,25,890.4000000000001,4,2,3,9,1,1
84824,19,2,31.9,3,1,1,5,0,0
84826,2,32,442.93,2,2,2,6,0,0
84827,5,14,154.39,3,1,2,6,0,0
84828,1,183,1571.3600000000001,1,4,3,8,0,0
84832,1,269,2723.75,1,4,4,9,1,1
84836,1,537,7470.57,1,4,4,9,1,1
84839,243,1,5.55,4,1,1,6,0,0
84840,260,7,93.44,4,1,1,6,0,0
84842,13,9,52.5,3,1,1,5,0,0
84843,2,49,975.75,2,2,3,7,0,0
84846A,60,13,128.14000000000001,4,1,1,6,0,0
84847,130,11,78.75,4,1,1,6,0,0
84849A,9,54,371.38,3,2,2,7,0,0
84849B,142,77,480.52,4,3,2,9,1,1
84849D,8,116,896.18,3,3,3,9,1,1
84854,374,1,24.75,4,1,1,6,0,0
84856L,267,2,17.82,4,1,1,6,0,0
84856S,240,2,22.41,4,1,1,6,0,0
84857B,141,2,50.699999999999996,4,1,1,6,0,0
84857C,157,11,234.28,4,1,2,7,0,0
84858C,241,6,261.68,4,1,2,7,0,0
84859A,1,35,272.99,1,2,2,5,0,0
84859B,1,11,66.75999999999999,1,1,1,3,0,0
84859C,5,22,180.51999999999998,3,2,2,7,0,0
84865,161,14,152.11,4,1,2,7,0,0
84870B,16,26,149.82999999999998,3,2,2,7,0,0
84870C,40,28,146.05,4,2,2,8,0,0
84872A,136,32,450.08,4,2,2,8,0,0
84872a,228,21,282.15,4,2,2,8,0,0
84873A,191,2,33.9,4,1,1,6,0,0
84874B,130,14,67.50999999999999,4,1,1,6,0,0
84875B,3,20,203.51,2,2,2,6,0,0
84875D,77,8,63.75,4,1,1,6,0,0
84876B,9,33,318.31,3,2,2,7,0,0
84876D,89,16,221.25,4,1,2,7,0,0
84877A,179,4,58.16,4,1,1,6,0,0
84877B,9,21,210.56,3,2,2,7,0,0
84877D,75,18,152.18,4,2,2,8,0,0
84879,1,1467,59230.13,1,4,4,9,1,1
84880,2,78,2082.84,2,3,3,8,0,0
84881,146,7,88.91999999999999,4,1,1,6,0,0
84882,9,18,157.34,3,2,2,7,0,0
84884A,3,79,1205.86,2,3,3,8,0,0
84884a,3,26,317.71999999999997,2,2,2,6,0,0
84898F,260,19,98.63000000000001,4,2,1,7,0,0
84905,163,20,173.48,4,2,2,8,0,0
84906,191,13,124.97,4,1,1,6,0,0
84907,79,23,180.93,4,2,2,8,0,0
84910A,142,17,192.14,4,2,2,8,0,0
84912A,79,74,560.62,4,3,2,9,1,1
84912B,4,160,1136.6,3,3,3,9,1,1
84913A,32,124,952.83,4,3,3,10,1,1
84913B,7,86,754.07,3,3,3,9,1,1
84915,3,23,372.33,2,2,2,6,0,0
84916,220,29,453.39,4,2,2,8,0,0
84917,198,27,466.3,4,2,2,8,0,0
84919,79,29,381.78000000000003,4,2,2,8,0,0
84920,2,48,453.73,2,2,2,6,0,0
84921,51,5,41.25,4,1,1,6,0,0
84922,7,6,42.29,3,1,1,5,0,0
84923,1,98,671.62,1,3,2,6,0,0
84924A,7,33,348.59000000000003,3,2,2,7,0,0
84924F,133,3,7.9,4,1,1,6,0,0
84925D,170,10,38.25,4,1,1,6,0,0
84925F,131,14,112.47999999999999,4,1,1,6,0,0
84926A,9,35,210.51999999999998,3,2,2,7,0,0
84926D,3,34,276.53,2,2,2,6,0,0
84926E,4,39,334.76,3,2,2,7,0,0
84926F,3,29,202.17999999999998,2,2,2,6,0,0
84927A,108,19,70.84,4,2,1,7,0,0
84927D,137,15,56.45,4,1,1,6,0,0
84927E,145,14,84.36,4,1,1,6,0,0
84927F,3,45,184.9,2,2,2,6,0,0
84929,15,69,806.0500000000001,3,3,3,9,1,1
84931A,10,51,322.53999999999996,3,2,2,7,0,0
84931B,4,50,439.38,3,2,2,7,0,0
84944,35,85,1217.61,4,3,3,10,1,1
84945,1,366,8852.09,1,4,4,9,1,1
84946,1,932,26262.59,1,4,4,9,1,1
84947,1,357,10335.560000000001,1,4,4,9,1,1
84949,1,325,8054.789999999999,1,4,4,9,1,1
84950,2,124,2310.9300000000003,2,3,4,9,1,1
84951A,4,94,572.76,3,3,2,8,0,0
84951B,2,82,554.78,2,3,2,7,0,0
84952A,25,26,264.46999999999997,3,2,2,7,0,0
84952B,3,30,343.39,2,2,2,6,0,0
84952C,60,12,255.0,4,1,2,7,0,0
84963A,370,1,171.8,4,1,2,7,0,0
84963B,127,1,149.85000000000002,4,1,2,7,0,0
84968A,5,101,3266.7999999999997,3,3,4,10,1,1
84968B,248,2,25.5,4,1,1,6,0,0
84968C,17,106,3636.99,3,3,4,10,1,1
84968D,2,56,1674.22,2,2,3,7,0,0
84968E,2,44,1522.53,2,2,3,7,0,0
84968F,27,65,1905.6799999999998,3,2,3,8,0,0
84968a,39,3,125.32999999999998,4,1,1,6,0,0
84968d,67,3,74.88,4,1,1,6,0,0
84968e,1,6,200.21,1,1,2,4,0,0
84968f,353,1,25.49,4,1,1,6,0,0
84969,3,212,2398.02,2,4,4,10,1,1
84970L,1,458,6424.17,1,4,4,9,1,1
84970S,1,543,7692.61,1,4,4,9,1,1
84970l,3,50,418.98,2,2,2,6,0,0
84970s,1,66,496.49,1,3,2,6,0,0
84971S,1,173,1562.55,1,4,3,8,0,0
84971l,14,1,4.92,3,1,1,5,0,0
84974,39,28,398.0,4,2,2,8,0,0
84975,366,2,8.45,4,1,1,6,0,0
84976,1,39,457.21000000000004,1,2,2,5,0,0
84977,267,1,1.25,4,1,1,6,0,0
84978,1,758,16684.12,1,4,4,9,1,1
84984A,32,6,88.35000000000001,4,1,1,6,0,0
84984B,32,5,79.05000000000001,4,1,1,6,0,0
84984D,32,4,60.45,4,1,1,6,0,0
84985A,283,19,68.15,4,2,1,7,0,0
84987,4,337,4495.82,3,4,4,11,1,1
84988,2,512,6691.549999999999,2,4,4,10,1,1
84989A,4,17,15.400000000000002,3,2,1,6,0,0
84989a,108,25,87.51,4,2,1,7,0,0
84990,215,2,1.1,4,1,1,6,0,0
84991,1,836,9279.42,1,4,4,9,1,1
84992,1,619,6617.47,1,4,4,9,1,1
84993A,1,55,159.69,1,2,2,5,0,0
84993B,123,18,24.36,4,2,1,7,0,0
84993a,5,19,26.56,3,2,1,6,0,0
84997A,1,263,9983.83,1,4,4,9,1,1
84997B,1,373,16173.470000000001,1,4,4,9,1,1
84997C,1,337,14524.08,1,4,4,9,1,1
84997D,1,476,19845.25,1,4,4,9,1,1
84997a,1,65,878.7399999999999,1,2,3,6,0,0
84997b,1,67,3052.9199999999996,1,3,4,8,0,0
84997c,1,62,2374.4399999999996,1,2,4,7,0,0
84997d,1,73,2657.79,1,3,4,8,0,0
85006,226,9,57.25,4,1,1,6,0,0
85008,243,8,66.12,4,1,1,6,0,0
85014A,4,279,6720.370000000001,3,4,4,11,1,1
85014B,1,352,10993.85,1,4,4,9,1,1
85014a,11,14,225.32000000000002,3,1,2,6,0,0
85014b,2,23,313.06,2,2,2,6,0,0
85015,1,143,1719.8400000000001,1,3,3,7,0,0
85016,193,42,560.11,4,2,2,8,0,0
85017A,250,8,13.58,4,1,1,6,0,0
85017B,31,159,610.49,3,3,2,8,0,0
85017C,211,10,27.02,4,1,1,6,0,0
85018D,329,7,30.599999999999998,4,1,1,6,0,0
85019A,2,33,564.35,2,2,2,6,0,0
85019B,2,36,682.97,2,2,2,6,0,0
85019C,184,12,321.72,4,1,2,7,0,0
85020,4,22,188.81,3,2,2,7,0,0
85023B,5,15,389.1,3,1,2,6,0,0
85023C,334,1,2.55,4,1,1,6,0,0
85024B,5,12,289.65,3,1,2,6,0,0
85024C,17,10,21.45,3,1,1,5,0,0
85025B,2,39,560.0699999999999,2,2,2,6,0,0
85025C,107,40,524.2099999999999,4,2,2,8,0,0
85026B,1,11,70.27,1,1,1,3,0,0
85027L,234,19,170.25,4,2,2,8,0,0
85028L,246,4,19.5,4,1,1,6,0,0
85028S,246,8,51.599999999999994,4,1,1,6,0,0
85030,246,6,29.25,4,1,1,6,0,0
85031A,240,7,45.9,4,1,1,6,0,0
85031B,358,1,4.95,4,1,1,6,0,0
85031C,359,1,14.850000000000001,4,1,1,6,0,0
85032A,2,135,777.1400000000001,2,3,3,8,0,0
85032B,2,133,747.7900000000001,2,3,3,8,0,0
85032C,1,141,727.64,1,3,3,7,0,0
85032D,64,94,569.14,4,3,2,9,1,1
85034A,17,77,935.9,3,3,3,9,1,1
85034B,2,120,1633.78,2,3,3,8,0,0
85034C,3,163,1878.0,2,3,3,8,0,0
85034a,31,3,24.869999999999997,3,1,1,5,0,0
85034b,14,1,8.29,3,1,1,5,0,0
85035A,44,84,820.55,4,3,3,10,1,1
85035B,43,70,1058.35,4,3,3,10,1,1
85035C,12,130,1779.41,3,3,3,9,1,1
85035a,353,2,16.94,4,1,1,6,0,0
85035b,353,1,8.47,4,1,1,6,0,0
85035c,367,1,8.47,4,1,1,6,0,0
85036A,24,61,760.6,3,2,3,8,0,0
85036B,22,50,634.9300000000001,3,2,2,7,0,0
85036C,16,87,1337.1100000000001,3,3,3,9,1,1
85036a,150,1,16.58,4,1,1,6,0,0
85036b,372,1,8.47,4,1,1,6,0,0
85038,1,142,2179.6600000000003,1,3,3,7,0,0
85039A,1,163,1015.5699999999999,1,3,3,7,0,0
85039B,1,172,1174.6299999999999,1,4,3,8,0,0
85039C,2,68,267.41999999999996,2,3,2,7,0,0
85039a,2,29,131.81,2,2,2,6,0,0
85040A,1,172,1638.6699999999998,1,4,3,8,0,0
85040B,242,38,236.06999999999996,4,2,2,8,0,0
85040a,9,21,105.28,3,2,1,6,0,0
85042,337,2,14.850000000000001,4,1,1,6,0,0
85045,38,12,210.9,4,1,2,7,0,0
85047,316,4,37.3,4,1,1,6,0,0
85048,1,283,11218.560000000001,1,4,4,9,1,1
85049A,1,324,3862.36,1,4,4,9,1,1
85049B,317,13,67.5,4,1,1,6,0,0
85049C,1,224,1518.19,1,4,3,8,0,0
85049D,72,107,697.49,4,3,3,10,1,1
85049E,1,411,3809.86,1,4,4,9,1,1
85049F,75,88,477.34,4,3,2,9,1,1
85049G,1,260,2025.44,1,4,3,8,0,0
85049H,1,184,870.35,1,4,3,8,0,0
85049a,1,36,812.84,1,2,3,6,0,0
85049b,80,2,4.92,4,1,1,6,0,0
85049c,17,1,2.46,3,1,1,5,0,0
85049d,213,2,4.92,4,1,1,6,0,0
85049e,1,42,360.71,1,2,2,5,0,0
85049g,1,51,276.42,1,2,2,5,0,0
85053,1,331,3723.4500000000003,1,4,4,9,1,1
85054,11,118,1444.93,3,3,3,9,1,1
85055,326,16,183.71,4,1,2,7,0,0
85059,1,130,1295.61,1,3,3,7,0,0
85061W,1,164,1903.3999999999999,1,3,3,7,0,0
85062,2,161,2455.8999999999996,2,3,4,9,1,1
85063,250,2,46.849999999999994,4,1,1,6,0,0
85064,243,32,985.55,4,2,3,9,1,1
85065,290,1,12.75,4,1,1,6,0,0
85066,1,544,23169.75,1,4,4,9,1,1
85067,330,5,126.64999999999999,4,1,1,6,0,0
85068,367,1,7.95,4,1,1,6,0,0
85071A,4,113,1031.63,3,3,3,9,1,1
85071B,2,126,694.8100000000001,2,3,3,8,0,0
85071C,1,105,428.0,1,3,2,6,0,0
85071D,4,84,249.48999999999998,3,3,2,8,0,0
85078,37,124,696.8,4,3,3,10,1,1
85084,354,7,17.0,4,1,1,6,0,0
85086A,119,50,122.08,4,2,1,7,0,0
85087,63,126,1132.94,4,3,3,10,1,1
85088,9,52,539.03,3,2,2,7,0,0
85089,22,5,41.300000000000004,3,1,1,5,0,0
85092,292,2,40.05,4,1,1,6,0,0
85093,36,88,475.18,4,3,2,9,1,1
85094,1,90,242.32,1,3,2,6,0,0
85095,4,48,243.49,3,2,2,7,0,0
85096,4,16,109.23,3,1,1,5,0,0
85098B,272,1,3.75,4,1,1,6,0,0
85099B,1,2132,96324.07,1,4,4,9,1,1
85099C,1,947,28603.08,1,4,4,9,1,1
85099F,1,825,33018.96,1,4,4,9,1,1
85099f,332,10,232.05999999999997,4,1,2,7,0,0
85103,144,29,1144.44,4,2,3,9,1,1
85104,4,18,534.6,3,2,2,7,0,0
85106,11,20,1147.4099999999999,3,2,3,8,0,0
85107,3,27,546.49,2,2,2,6,0,0
85109,355,1,10.2,4,1,1,6,0,0
85111,1,57,441.07,1,2,2,5,0,0
85114A,8,56,1105.21,3,2,3,8,0,0
85114B,1,78,907.4399999999999,1,3,3,7,0,0
85114C,1,75,920.2199999999999,1,3,3,7,0,0
85114a,184,15,161.70000000000002,4,1,2,7,0,0
85114b,2,14,118.86000000000001,2,1,1,4,0,0
85114c,5,35,534.66,3,2,2,7,0,0
85115B,59,1,24.869999999999997,4,1,1,6,0,0
85116,57,91,1169.88,4,3,3,10,1,1
85118,322,12,160.77,4,1,2,7,0,0
85119,367,1,3.36,4,1,1,6,0,0
85123A,1,2240,111143.1,1,4,4,9,1,1
85123a,2,67,1952.4799999999998,2,3,3,8,0,0
85124B,16,40,279.35999999999996,3,2,2,7,0,0
85124C,48,39,261.89,4,2,2,8,0,0
85125,13,33,770.2900000000001,3,2,3,8,0,0
85126,316,2,33.89,4,1,1,6,0,0
85127,1,52,1131.29,1,2,3,6,0,0
85129B,4,31,168.59,3,2,2,7,0,0
85129C,2,15,107.31,2,1,1,4,0,0
85129D,4,65,343.99,3,2,2,7,0,0
85130A,200,10,127.04999999999998,4,1,1,6,0,0
85130B,2,62,760.4300000000001,2,2,3,7,0,0
85130C,2,46,438.87,2,2,2,6,0,0
85130D,2,62,569.29,2,2,2,6,0,0
85131A,40,122,912.75,4,3,3,10,1,1
85131B,1,172,521.11,1,4,2,7,0,0
85131C,25,50,178.85,3,2,2,7,0,0
85131D,1,206,725.26,1,4,3,8,0,0
85132A,200,112,1569.57,4,3,3,10,1,1
85132B,173,75,1156.1699999999998,4,3,3,10,1,1
85132C,99,215,3572.0699999999997,4,4,4,12,1,1
85132a,213,8,92.19999999999999,4,1,1,6,0,0
85132b,171,9,74.60999999999999,4,1,1,6,0,0
85132c,228,3,24.869999999999997,4,1,1,6,0,0
85135A,11,8,151.05,3,1,2,6,0,0
85135B,22,46,532.5,3,2,2,7,0,0
85135C,1,68,864.33,1,3,3,7,0,0
85136A,4,53,580.36,3,2,2,7,0,0
85136B,360,2,15.9,4,1,1,6,0,0
85136C,1,36,421.18,1,2,2,5,0,0
85141,176,42,676.29,4,2,2,8,0,0
85144,220,41,586.6,4,2,2,8,0,0
85145,225,13,167.70000000000002,4,1,2,7,0,0
85146,246,9,171.11,4,1,2,7,0,0
85150,1,482,9400.83,1,4,4,9,1,1
85152,1,680,16118.550000000001,1,4,4,9,1,1
85159A,5,53,865.75,3,2,3,8,0,0
85159B,9,72,1221.04,3,3,3,9,1,1
85160A,318,1,7.5,4,1,1,6,0,0
85160B,26,17,63.019999999999996,3,2,1,6,0,0
85160a,353,1,16.13,4,1,1,6,0,0
85161,13,20,568.65,3,2,2,7,0,0
85163A,16,32,559.0,3,2,2,7,0,0
85163B,4,37,796.43,3,2,3,8,0,0
85167B,246,8,109.94,4,1,1,6,0,0
85168B,1,35,432.78999999999996,1,2,2,5,0,0
85169A,1,89,828.02,1,3,3,7,0,0
85169B,2,62,356.06,2,2,2,6,0,0
85169C,1,47,467.86,1,2,2,5,0,0
85169D,11,51,357.33,3,2,2,7,0,0
85170A,367,1,2.1,4,1,1,6,0,0
85170B,10,40,318.85,3,2,2,7,0,0
85170C,1,72,608.53,1,3,2,6,0,0
85170D,1,102,804.99,1,3,3,7,0,0
85172,3,45,617.14,2,2,2,6,0,0
85173,1,87,807.77,1,3,3,7,0,0
85174,1,160,2961.0299999999997,1,3,4,8,0,0
85175,8,147,2333.5,3,3,4,10,1,1
85176,1,173,881.3199999999999,1,4,3,8,0,0
85177,1,64,645.91,1,2,2,5,0,0
85178,1,145,3146.68,1,3,4,8,0,0
85179A,1,59,380.79,1,2,2,5,0,0
85179C,1,36,201.31,1,2,2,5,0,0
85179a,11,1,2.46,3,1,1,5,0,0
85180A,4,64,1070.56,3,2,3,8,0,0
85180B,3,48,587.2,2,2,2,6,0,0
85183A,4,88,854.54,3,3,3,9,1,1
85183B,5,118,1323.37,3,3,3,9,1,1
85184C,1,193,2997.64,1,4,4,9,1,1
85184c,44,2,11.58,4,1,1,6,0,0
85185B,9,72,929.8900000000001,3,3,3,9,1,1
85185D,198,8,44.25000000000001,4,1,1,6,0,0
85186A,239,79,293.8,4,3,2,9,1,1
85186C,51,79,277.57,4,3,2,9,1,1
85187,12,69,556.53,3,3,2,8,0,0
85188A,141,43,280.71999999999997,4,2,2,8,0,0
85188B,258,10,68.69999999999999,4,1,1,6,0,0
85189,268,3,7.6499999999999995,4,1,1,6,0,0
85194L,17,76,847.54,3,3,3,9,1,1
85194S,6,75,507.56000000000006,3,3,2,8,0,0
85195,268,3,23.1,4,1,1,6,0,0
85197,133,19,73.5,4,2,1,7,0,0
85198,205,9,74.58,4,1,1,6,0,0
85199L,1,97,671.8800000000001,1,3,2,6,0,0
85199S,1,262,1315.33,1,4,3,8,0,0
85200,235,26,228.75,4,2,2,8,0,0
85202,10,106,314.81,3,3,2,8,0,0
85203,4,127,409.41,3,3,2,8,0,0
85204,2,105,326.08,2,3,2,7,0,0
85205B,232,29,323.15,4,2,2,8,0,0
85206A,267,114,1572.2299999999998,4,3,3,10,1,1
85206B,323,4,23.099999999999998,4,1,1,6,0,0
85208,11,48,419.01000000000005,3,2,2,7,0,0
85211,58,25,176.73999999999998,4,2,2,8,0,0
85212,2,79,761.4,2,3,3,8,0,0
85213,132,34,334.87999999999994,4,2,2,8,0,0
85214,121,58,271.03999999999996,4,2,2,8,0,0
85215,121,18,180.71,4,2,2,8,0,0
85216,22,8,35.75,3,1,1,5,0,0
85224,261,1,6.300000000000001,4,1,1,6,0,0
85225,3,3,6.25,2,1,1,4,0,0
85227,1,223,1368.75,1,4,3,8,0,0
85230A,7,18,203.27999999999997,3,2,2,7,0,0
85230B,3,39,333.2,2,2,2,6,0,0
85230E,89,24,267.45,4,2,2,8,0,0
85230F,29,12,90.33999999999999,3,1,1,5,0,0
85230G,7,26,270.96,3,2,2,7,0,0
85231B,1,152,786.93,1,3,3,7,0,0
85231G,58,82,509.77,4,3,2,9,1,1
85231b,239,3,4.92,4,1,1,6,0,0
85231g,213,6,9.78,4,1,1,6,0,0
85232A,186,30,404.40000000000003,4,2,2,8,0,0
85232B,301,19,2619.3,4,2,4,10,1,1
85232D,2,70,1012.32,2,3,3,8,0,0
90000A,23,8,77.91,3,1,1,5,0,0
90000B,137,7,67.83,4,1,1,6,0,0
90000D,14,14,129.85,3,1,2,6,0,0
90001A,39,4,20.950000000000003,4,1,1,6,0,0
90001B,31,3,21.15,3,1,1,5,0,0
90001C,50,5,21.130000000000003,4,1,1,6,0,0
90001D,61,5,29.73,4,1,1,6,0,0
90002D,215,9,48.71,4,1,1,6,0,0
90003B,10,11,71.31,3,1,1,5,0,0
90003C,1,25,134.84,1,2,2,5,0,0
90003D,10,17,127.26,3,2,1,6,0,0
90003E,1,15,101.11,1,1,1,3,0,0
90005A,226,10,28.02,4,1,1,6,0,0
90010A,1,15,167.3,1,1,2,4,0,0
90010B,244,7,100.08999999999999,4,1,1,6,0,0
90010E,7,16,227.89,3,1,2,6,0,0
90011A,15,6,17.509999999999998,3,1,1,5,0,0
90011B,9,7,35.27,3,1,1,5,0,0
90011C,16,2,5.8,3,1,1,5,0,0
90011D,17,3,8.76,3,1,1,5,0,0
90011E,85,3,8.76,4,1,1,6,0,0
90012A,60,5,53.760000000000005,4,1,1,6,0,0
90012B,27,3,45.35000000000001,3,1,1,5,0,0
90013A,1,33,225.32,1,2,2,5,0,0
90013B,9,31,149.41000000000003,3,2,2,7,0,0
90013C,1,28,158.08,1,2,2,5,0,0
90013D,163,3,25.17,4,1,1,6,0,0
90014A,1,21,217.59,1,2,2,5,0,0
90014B,45,15,158.73999999999998,4,1,2,7,0,0
90014C,12,4,43.199999999999996,3,1,1,5,0,0
90016A,45,7,105.71000000000001,4,1,1,6,0,0
90016B,1,19,184.66,1,2,2,5,0,0
90016C,2,3,24.96,2,1,1,4,0,0
90018A,1,38,197.58,1,2,2,5,0,0
90018B,1,17,92.28,1,2,1,4,0,0
90018C,14,10,54.650000000000006,3,1,1,5,0,0
90019A,4,27,197.09,3,2,2,7,0,0
90019B,1,18,96.52000000000001,1,2,1,4,0,0
90019C,2,11,68.73,2,1,1,4,0,0
90020,102,1,12.48,4,1,1,6,0,0
90021,227,1,11.95,4,1,1,6,0,0
90022,1,21,105.2,1,2,1,4,0,0
90023,12,9,55.02,3,1,1,5,0,0
90024B,4,7,84.28,3,1,1,5,0,0
90024C,137,3,33.81,4,1,1,6,0,0
90024D,71,2,16.82,4,1,1,6,0,0
90024E,255,2,16.810000000000002,4,1,1,6,0,0
90024F,9,4,42.13,3,1,1,5,0,0
90025A,61,2,7.5,4,1,1,6,0,0
90025B,232,1,3.73,4,1,1,6,0,0
90025D,71,3,11.19,4,1,1,6,0,0
90025E,186,1,3.73,4,1,1,6,0,0
90025F,50,4,14.96,4,1,1,6,0,0
90026A,179,1,17.0,4,1,1,6,0,0
90026B,253,3,25.32,4,1,1,6,0,0
90026C,31,3,33.82,3,1,1,5,0,0
90026D,21,3,25.5,3,1,1,5,0,0
90027A,102,3,17.66,4,1,1,6,0,0
90027B,14,3,8.76,3,1,1,5,0,0
90027C,14,5,14.5,3,1,1,5,0,0
90027D,1,6,28.4,1,1,1,3,0,0
90028,37,14,134.16,4,1,2,7,0,0
90029,102,4,42.14,4,1,1,6,0,0
90030A,11,7,72.0,3,1,1,5,0,0
90030B,1,25,190.73000000000002,1,2,2,5,0,0
90030C,15,11,91.7,3,1,1,5,0,0
90031,15,7,59.89,3,1,1,5,0,0
90032,45,8,103.13,4,1,1,6,0,0
90033,10,9,25.07,3,1,1,5,0,0
90034,235,2,20.17,4,1,1,6,0,0
90035A,240,3,53.62,4,1,1,6,0,0
90035C,210,1,21.5,4,1,1,6,0,0
90036A,126,4,47.7,4,1,1,6,0,0
90036B,130,2,31.8,4,1,1,6,0,0
90036C,7,5,71.4,3,1,1,5,0,0
90036D,179,5,95.35000000000001,4,1,1,6,0,0
90036E,50,11,110.95,4,1,1,6,0,0
90036F,262,5,64.08,4,1,1,6,0,0
90037A,319,1,2.48,4,1,1,6,0,0
90037B,3,5,25.279999999999998,2,1,1,4,0,0
90037C,3,5,12.52,2,1,1,4,0,0
90038A,16,10,56.15,3,1,1,5,0,0
90038B,1,8,48.77,1,1,1,3,0,0
90038C,98,4,33.69,4,1,1,6,0,0
90039A,4,3,29.96,3,1,1,5,0,0
90039B,135,6,41.31,4,1,1,6,0,0
90039C,2,6,22.48,2,1,1,4,0,0
90039D,3,9,78.69,2,1,1,4,0,0
90040A,278,5,54.290000000000006,4,1,1,6,0,0
90040B,217,11,66.7,4,1,1,6,0,0
90040C,6,10,54.42,3,1,1,5,0,0
90041,7,4,18.27,3,1,1,5,0,0
90042A,240,2,7.6499999999999995,4,1,1,6,0,0
90042C,332,5,12.7,4,1,1,6,0,0
90043,53,2,24.810000000000002,4,1,1,6,0,0
90046,155,1,14.850000000000001,4,1,1,6,0,0
90048,155,1,14.850000000000001,4,1,1,6,0,0
90049,16,3,34.77,3,1,1,5,0,0
90050,25,5,69.62,3,1,1,5,0,0
90051,61,7,70.16,4,1,1,6,0,0
90052,24,2,14.14,3,1,1,5,0,0
90053,63,4,9.99,4,1,1,6,0,0
90054,2,9,22.58,2,1,1,4,0,0
90055,1,5,12.53,1,1,1,3,0,0
90056,3,4,43.510000000000005,2,1,1,4,0,0
90057,1,22,1311.3600000000001,1,2,3,6,0,0
90058A,3,8,136.8,2,1,2,5,0,0
90058B,3,16,246.24,2,1,2,5,0,0
90059A,1,28,84.42999999999999,1,2,1,4,0,0
90059B,4,11,36.419999999999995,3,1,1,5,0,0
90059C,1,11,34.69,1,1,1,3,0,0
90059D,1,20,51.349999999999994,1,2,1,4,0,0
90059E,1,16,51.269999999999996,1,1,1,3,0,0
90059F,1,15,44.589999999999996,1,1,1,3,0,0
90060B,359,1,5.95,4,1,1,6,0,0
90060D,359,3,17.85,4,1,1,6,0,0
90060F,14,6,35.160000000000004,3,1,1,5,0,0
90062,225,27,570.78,4,2,2,8,0,0
90063A,37,8,102.0,4,1,1,6,0,0
90063B,37,6,76.32,4,1,1,6,0,0
90064A,22,6,38.7,3,1,1,5,0,0
90064B,59,8,48.75,4,1,1,6,0,0
90065A,166,4,60.75,4,1,1,6,0,0
90065B,30,2,13.5,3,1,1,5,0,0
90067A,25,7,41.150000000000006,3,1,1,5,0,0
90067B,135,2,5.8,4,1,1,6,0,0
90068,267,1,7.5,4,1,1,6,0,0
90069,37,1,15.0,4,1,1,6,0,0
90070,16,15,140.49,3,1,2,6,0,0
90071,4,33,54.62,3,2,1,6,0,0
90072,1,14,83.42,1,1,1,3,0,0
90073,2,18,134.70000000000002,2,2,2,6,0,0
90074,11,3,37.239999999999995,3,1,1,5,0,0
90075,16,3,37.66,3,1,1,5,0,0
90076,16,5,26.669999999999998,3,1,1,5,0,0
90077,93,3,8.82,4,1,1,6,0,0
90078,361,1,15.0,4,1,1,6,0,0
90079,61,4,49.760000000000005,4,1,1,6,0,0
90081A,2,8,74.25,2,1,1,4,0,0
90081B,205,1,4.95,4,1,1,6,0,0
90081C,2,15,99.60000000000001,2,1,1,4,0,0
90082A,2,18,193.2,2,2,2,6,0,0
90082B,2,10,171.45,2,1,2,5,0,0
90082D,12,5,64.38,3,1,1,5,0,0
90083,2,9,23.47,2,1,1,4,0,0
90084,279,1,0.85,4,1,1,6,0,0
90085,7,10,36.76,3,1,1,5,0,0
90086,1,28,77.78999999999999,1,2,1,4,0,0
90087,1,25,61.459999999999994,1,2,1,4,0,0
90089,1,9,16.22,1,1,1,3,0,0
90092,332,1,1.66,4,1,1,6,0,0
90093,3,10,28.569999999999997,2,1,1,4,0,0
90094,4,13,35.699999999999996,3,1,1,5,0,0
90096,26,26,112.21,3,2,1,6,0,0
90098,15,11,89.25,3,1,1,5,0,0
90099,4,16,76.38,3,1,1,5,0,0
90100,289,1,2.55,4,1,1,6,0,0
90101,2,18,113.36999999999999,2,2,1,5,0,0
90102,186,1,8.5,4,1,1,6,0,0
90103,4,16,72.66,3,1,1,5,0,0
90104,235,12,23.16,4,1,1,6,0,0
90108,8,13,92.46000000000001,3,1,1,5,0,0
90112,351,1,2.1,4,1,1,6,0,0
90114,1,88,417.96,1,3,2,6,0,0
90115,191,31,134.53,4,2,2,8,0,0
90116,1,45,145.52,1,2,2,5,0,0
90118,4,20,89.94,3,2,1,6,0,0
90119,1,36,207.60999999999999,1,2,2,5,0,0
90120A,319,3,29.73,4,1,1,6,0,0
90120B,1,15,164.12,1,1,2,4,0,0
90120C,1,22,215.20000000000002,1,2,2,5,0,0
90120D,303,5,41.790000000000006,4,1,1,6,0,0
90122A,24,14,109.48,3,1,1,5,0,0
90122B,99,6,29.93,4,1,1,6,0,0
90122C,7,11,119.23,3,1,1,5,0,0
90123A,60,9,89.12,4,1,1,6,0,0
90123B,130,5,53.42,4,1,1,6,0,0
90123C,130,6,83.29,4,1,1,6,0,0
90123D,11,5,35.31,3,1,1,5,0,0
90124A,41,6,79.66,4,1,1,6,0,0
90124B,28,11,119.89,3,1,1,5,0,0
90124C,36,8,109.53999999999999,4,1,1,6,0,0
90125A,149,10,106.24,4,1,1,6,0,0
90125B,7,12,48.06,3,1,1,5,0,0
90125C,197,7,69.85,4,1,1,6,0,0
90125D,149,19,110.03,4,2,1,7,0,0
90125E,197,10,21.05,4,1,1,6,0,0
90126A,362,1,3.36,4,1,1,6,0,0
90126C,147,1,6.58,4,1,1,6,0,0
90127A,147,1,4.92,4,1,1,6,0,0
90128A,136,2,7.43,4,1,1,6,0,0
90128B,365,2,3.76,4,1,1,6,0,0
90128C,72,2,4.97,4,1,1,6,0,0
90128D,298,2,4.97,4,1,1,6,0,0
90129A,67,20,82.97999999999999,4,2,1,7,0,0
90129B,2,20,121.38000000000001,2,2,1,5,0,0
90129C,2,16,79.76,2,1,1,4,0,0
90129D,51,7,33.440000000000005,4,1,1,6,0,0
90129E,16,14,77.03999999999999,3,1,1,5,0,0
90129F,2,16,88.03,2,1,1,4,0,0
90130A,14,6,17.5,3,1,1,5,0,0
90130B,1,31,113.97,1,2,1,4,0,0
90130C,1,13,40.95,1,1,1,3,0,0
90130D,11,3,8.7,3,1,1,5,0,0
90131,191,2,34.870000000000005,4,1,1,6,0,0
90132,102,3,15.16,4,1,1,6,0,0
90133,7,13,94.43,3,1,1,5,0,0
90134,1,45,157.5,1,2,2,5,0,0
90135,228,2,39.660000000000004,4,1,1,6,0,0
90135A,235,1,4.98,4,1,1,6,0,0
90136,228,2,29.849999999999998,4,1,1,6,0,0
90137,142,3,16.310000000000002,4,1,1,6,0,0
90138,1,7,52.42,1,1,1,3,0,0
90140,102,2,15.120000000000001,4,1,1,6,0,0
90141A,9,10,63.11,3,1,1,5,0,0
90141B,1,5,44.86,1,1,1,3,0,0
90141C,17,8,52.31,3,1,1,5,0,0
90141D,145,2,20.36,4,1,1,6,0,0
90141E,59,2,24.75,4,1,1,6,0,0
90142A,357,1,5.09,4,1,1,6,0,0
90142D,47,4,49.64,4,1,1,6,0,0
90143,8,20,267.18,3,2,2,7,0,0
90144,11,14,67.36,3,1,1,5,0,0
90145,1,18,168.0,1,2,2,5,0,0
90146,2,7,95.35000000000001,2,1,1,4,0,0
90147,12,24,343.90999999999997,3,2,2,7,0,0
90148,74,7,139.98,4,1,2,7,0,0
90149,7,4,342.76000000000005,3,1,2,6,0,0
90151,12,4,68.0,3,1,1,5,0,0
90152A,9,5,28.76,3,1,1,5,0,0
90152B,362,2,11.46,4,1,1,6,0,0
90152C,298,1,5.95,4,1,1,6,0,0
90154,21,5,421.75,3,1,2,6,0,0
90155,1,7,67.62,1,1,1,3,0,0
90156,96,3,19.8,4,1,1,6,0,0
90157,11,5,49.59,3,1,1,5,0,0
90158,2,35,224.12,2,2,2,6,0,0
90159,30,5,29.790000000000003,3,1,1,5,0,0
90160A,3,16,313.59000000000003,2,1,2,5,0,0
90160B,30,12,209.73000000000002,3,1,2,6,0,0
90160C,2,26,377.04,2,2,2,6,0,0
90160D,22,12,264.7,3,1,2,6,0,0
90161A,2,21,119.91000000000001,2,2,1,5,0,0
90161B,2,37,377.88,2,2,2,6,0,0
90161C,2,50,412.74,2,2,2,6,0,0
90161D,1,34,318.89000000000004,1,2,2,5,0,0
90162A,33,1,17.700000000000003,4,1,1,6,0,0
90162B,31,11,82.60000000000001,3,1,1,5,0,0
90162C,40,7,41.300000000000004,4,1,1,6,0,0
90162D,40,5,29.500000000000004,4,1,1,6,0,0
90163A,1,9,90.32,1,1,1,3,0,0
90163B,4,5,52.72,3,1,1,5,0,0
90164A,7,14,130.67,3,1,2,6,0,0
90164B,4,15,140.98,3,1,2,6,0,0
90165A,23,15,39.98,3,1,1,5,0,0
90165B,1,18,47.43,1,2,1,4,0,0
90166,2,15,88.04,2,1,1,4,0,0
90167,370,1,8.5,4,1,1,6,0,0
90168,1,13,70.26,1,1,1,3,0,0
90169,1,12,63.14,1,1,1,3,0,0
90170,1,38,160.13,1,2,2,5,0,0
90173,59,17,120.34,4,2,1,7,0,0
90174,1,23,126.02,1,2,1,4,0,0
90175A,1,25,245.63,1,2,2,5,0,0
90175B,30,9,91.68,3,1,1,5,0,0
90175C,22,6,80.55,3,1,1,5,0,0
90175D,1,20,210.04,1,2,2,5,0,0
90176A,31,3,29.98,3,1,1,5,0,0
90176B,23,3,30.12,3,1,1,5,0,0
90176C,109,2,23.32,4,1,1,6,0,0
90176D,31,5,60.0,3,1,1,5,0,0
90176E,7,3,29.98,3,1,1,5,0,0
90177A,1,10,58.60000000000001,1,1,1,3,0,0
90177B,1,7,41.010000000000005,1,1,1,3,0,0
90177C,1,15,93.93,1,1,1,3,0,0
90177D,7,15,91.23,3,1,1,5,0,0
90177E,18,10,58.78000000000001,3,1,1,5,0,0
90178A,50,8,95.25,4,1,1,6,0,0
90178B,357,1,11.95,4,1,1,6,0,0
90179A,2,5,35.31,2,1,1,4,0,0
90179B,4,3,17.59,3,1,1,5,0,0
90179C,9,6,35.44,3,1,1,5,0,0
90180A,10,9,127.24,3,1,1,5,0,0
90180B,3,5,49.81,2,1,1,4,0,0
90181A,9,7,64.04,3,1,1,5,0,0
90181B,1,14,137.63,1,1,2,4,0,0
90181C,235,1,9.15,4,1,1,6,0,0
90182A,3,8,23.2,2,1,1,4,0,0
90182B,2,5,14.5,2,1,1,4,0,0
90182C,1,10,58.660000000000004,1,1,1,3,0,0
90183A,1,24,134.94,1,2,2,5,0,0
90183B,4,17,61.08,3,2,1,6,0,0
90183C,1,9,26.15,1,1,1,3,0,0
90183c,39,1,2.9,4,1,1,6,0,0
90184A,29,9,117.73,3,1,1,5,0,0
90184B,4,21,297.94,3,2,2,7,0,0
90184C,1,17,190.51999999999998,1,2,2,5,0,0
90184c,39,1,9.15,4,1,1,6,0,0
90185A,23,14,156.53,3,1,2,6,0,0
90185B,1,14,135.27,1,1,2,4,0,0
90185C,39,13,178.09,4,1,2,7,0,0
90185D,190,11,148.63,4,1,2,7,0,0
90186A,10,9,35.11,3,1,1,5,0,0
90186B,11,15,64.58,3,1,1,5,0,0
90187A,284,1,3.32,4,1,1,6,0,0
90187B,2,8,40.03,2,1,1,4,0,0
90188,1,7,25.13,1,1,1,3,0,0
90189A,21,2,15.0,3,1,1,5,0,0
90190A,16,10,46.76,3,1,1,5,0,0
90190B,17,7,38.18,3,1,1,5,0,0
90190C,11,19,58.43,3,2,1,6,0,0
90191,1,10,163.82,1,1,2,4,0,0
90192,1,26,219.0,1,2,2,5,0,0
90194,51,10,67.87,4,1,1,6,0,0
90195A,4,10,122.84,3,1,1,5,0,0
90195B,30,4,29.98,3,1,1,5,0,0
90196A,11,5,102.0,3,1,1,5,0,0
90196B,30,5,63.480000000000004,3,1,1,5,0,0
90197B,3,27,174.73000000000002,2,2,2,6,0,0
90198A,1,44,315.73,1,2,2,5,0,0
90198B,6,17,152.4,3,2,2,7,0,0
90199A,37,6,69.63,4,1,1,6,0,0
90199B,7,8,56.59,3,1,1,5,0,0
90199C,10,11,139.34,3,1,2,6,0,0
90199D,10,6,37.620000000000005,3,1,1,5,0,0
90200A,1,50,328.44,1,2,2,5,0,0
90200B,2,48,397.08,2,2,2,6,0,0
90200C,263,26,211.43,4,2,2,8,0,0
90200D,2,78,729.57,2,3,3,8,0,0
90200E,2,44,423.41,2,2,2,6,0,0
90201A,1,29,214.31,1,2,2,5,0,0
90201B,1,25,273.55,1,2,2,5,0,0
90201C,1,22,203.12000000000003,1,2,2,5,0,0
90201D,1,31,225.84,1,2,2,5,0,0
90202A,1,16,81.98,1,1,1,3,0,0
90202B,1,11,67.35000000000001,1,1,1,3,0,0
90202C,1,15,76.41000000000001,1,1,1,3,0,0
90202D,1,12,82.16000000000001,1,1,1,3,0,0
90204,8,19,110.26,3,2,1,6,0,0
90205A,16,16,51.51,3,1,1,5,0,0
90205C,11,15,48.209999999999994,3,1,1,5,0,0
90206A,2,9,59.800000000000004,2,1,1,4,0,0
90206C,1,31,229.68,1,2,2,5,0,0
90208,1,38,148.0,1,2,2,5,0,0
90209A,36,5,176.4,4,1,2,7,0,0
90209B,69,54,357.74,4,2,2,8,0,0
90209C,39,32,486.8,4,2,2,8,0,0
90210A,1,10,57.55,1,1,1,3,0,0
90210B,1,7,61.56,1,1,1,3,0,0
90210C,1,10,130.51000000000002,1,1,2,4,0,0
90210D,29,8,132.05,3,1,2,6,0,0
90211A,4,8,70.97,3,1,1,5,0,0
90211B,37,7,65.16,4,1,1,6,0,0
90212B,217,8,37.62,4,1,1,6,0,0
90212C,94,3,26.25,4,1,1,6,0,0
90214A,1,56,111.66,1,2,1,4,0,0
90214B,4,22,24.77,3,2,1,6,0,0
90214C,1,33,72.77,1,2,1,4,0,0
90214D,1,32,49.9,1,2,1,4,0,0
90214E,1,30,53.199999999999996,1,2,1,4,0,0
90214F,2,15,15.429999999999998,2,1,1,4,0,0
90214G,2,30,40.199999999999996,2,2,1,5,0,0
90214H,2,30,36.76,2,2,1,5,0,0
90214I,1,13,29.619999999999997,1,1,1,3,0,0
90214J,3,41,57.21,2,2,1,5,0,0
90214K,1,38,60.699999999999996,1,2,1,4,0,0
90214L,1,37,65.03999999999999,1,2,1,4,0,0
90214M,4,28,49.82,3,2,1,6,0,0
90214N,1,24,29.23,1,2,1,4,0,0
90214O,3,5,6.819999999999999,2,1,1,4,0,0
90214P,1,16,20.229999999999997,1,1,1,3,0,0
90214R,1,25,28.009999999999998,1,2,1,4,0,0
90214S,1,41,71.0,1,2,1,4,0,0
90214T,4,11,13.459999999999999,3,1,1,5,0,0
90214U,4,1,3.4799999999999995,3,1,1,5,0,0
90214V,4,14,15.979999999999999,3,1,1,5,0,0
90214W,4,5,6.819999999999999,3,1,1,5,0,0
90214Y,3,8,22.839999999999996,2,1,1,4,0,0
90214Z,4,10,11.84,3,1,1,5,0,0
AMAZONFEE,5,34,249042.68,3,2,4,9,1,1
B,119,3,33186.18,4,1,4,9,1,1
BANK CHARGES,3,36,7505.641,2,2,4,8,0,0
C2,5,143,7116.0,3,3,4,10,1,1
CRUK,4,16,7933.43,3,1,4,8,0,0
D,9,65,5696.22,3,2,4,9,1,1
DCGS0003,218,4,9.94,4,1,1,6,0,0
DCGS0004,226,1,16.63,4,1,1,6,0,0
DCGS0069,315,1,15.79,4,1,1,6,0,0
DCGS0070,353,1,12.72,4,1,1,6,0,0
DCGS0076,354,2,48.39,4,1,1,6,0,0
DCGSSBOY,8,11,150.54999999999998,3,1,2,6,0,0
DCGSSGIRL,23,13,144.43,3,1,2,6,0,0
DOT,1,707,206252.06,1,4,4,9,1,1
M,1,512,224894.73,1,4,4,9,1,1
PADS,75,3,0.003,4,1,1,6,0,0
POST,1,1250,89973.12,1,4,4,9,1,1
S,21,19,3175.49,3,2,4,9,1,1
gift_0001_10,2,8,74.97,2,1,1,4,0,0
gift_0001_20,39,9,167.05,4,1,2,7,0,0
gift_0001_30,99,7,175.53,4,1,2,7,0,0
gift_0001_40,135,3,100.69999999999999,4,1,1,6,0,0
gift_0001_50,162,4,167.56,4,1,2,7,0,0
m,353,1,2.55,4,1,1,6,0,0
